german word	german sentence	english translation
da(1)	Welche Bluse nehmen Sie? - Die da.	Which blouse are you taking? - That one.
da(2)	Ist Herr Klein schon da?	Is Mr. Klein already here?
da(3)	Wir sprechen gerade über Paul. Da kommt er ja.	We’re talking about Paul. Here he comes.
da(4)	Da drüben ist der Bahnhof.	The train station is over there.
da(r) (Bsp. darauf, darüber)(1)	Darauf fällt mir keine Antwort ein.	I can’t think of an answer to that.
da(r) (Bsp. darauf, darüber)(2)	Darüber spreche ich nicht gern.	I don’t like to talk about that.
dabei(1)	Hast du einen Stift dabei?	Do you have a pen with you?
dabei(2)	Schön, dass du da bist. Ist deine Familie auch dabei?	Good to have you here. Is your family here too?
ist dabei		
war dabei		
ist dabei gewesen		
dafür/dagegen sein(1)	Ich bin dafür/dagegen.	I’m in favor/against.
ist dafür/dagegen		
war dafür/dagegen		
ist dafür/dagegen gewesen		
damals	Als Student hatte ich viel Zeit und wollte reisen. Aber damals hatte ich kein Geld.	As a student, I had a lot of time and wanted to travel. But back then I didn’t have any money.
die Dame, -n	Damen (an der Toilette)	Ladies (at the toilet)
die Dame(2)	Sehr geehrte Damen und Herren,	Dear Ladies and Gentlemen,
daneben	Du weißt doch, wo die Post ist. Daneben ist die Bank.	You know where the post office is. Next to it is the bank.
der Dank (Sg.)	Vielen Dank!	Thank you very much!
der Dank (Sg.)(2)	Herzlichen Dank!	Heartfelt thanks!
danke	Soll ich Ihnen helfen? - Sehr freundlich, ja danke!	Should I help you? - Very kind, yes thank you!
danke(2)	Guten Appetit! - Danke gleichfalls.	Enjoy your meal! - Thanks, same to you.
danken, dankt	Ich danke Ihnen für die Einladung.	I thank you for the invitation.
hat gedankt		
dann	Ich muss noch schnell zur Post, dann komme ich.	I need to quickly go to the post office, then I’ll come.
dann(2)	Wenn es nicht regnet, dann kommen wir.	If it doesn’t rain, then we’ll come.
dass	Rico hat gesagt, dass er auch zur Party kommt.	Rico said that he is also coming to the party.
dass(2)	Ich finde es super, dass du mich besuchst.	I think it’s great that you’re visiting me.
die Datei, -en	Wo hast du die Datei gespeichert?	Where did you save the file?
die Datei(2)	Kannst du die Datei bitte öffnen?	Can you please open the file?
das Datum, -en	Bitte Datum und Unterschrift nicht vergessen!	Please don’t forget the date and signature!
das Datum(2)	Welches Datum haben wir heute?	What’s the date today?
das Datum(3)	Haben Sie meine Kontaktdaten?	Do you have my contact details?
dauern, dauert	Wie lange dauert die Pause? - Eine halbe Stunde.	How long does the break last? - Half an hour.
hat gedauert		
denken, denkt	Ich denke, du hast recht.	I think you’re right.
hat gedacht		
denken(3)	Was denktst du? Sollen wir heute Abend ins Kino gehen?	What do you think? Should we go to the cinema tonight?
denn	Ich kann nicht kommen, denn ich bin krank.	I can’t come because I’m sick.
deshalb	Ich bin krank. Deshalb komme ich heute nicht ins Büro.	I’m sick. Therefore, I’m not coming to the office today.
deutlich	Sprechen Sie bitte deutlich!	Please speak clearly!
deutlich(2)	Können Sie das bitte deutlicher schreiben? Ich kann das nicht lesen.	Could you write that more clearly, please? I can’t read it.
dick	Ich bin zu dick. Ich muss weniger essen.	I’m too fat. I need to eat less.
das Ding, -e	Gib mir bitte mal das Ding da drüben!	Please hand me that thing over there!
das Ding(2)	Was macht man mit diesem Ding? - Damit kann man Flaschen öffnen.	What do you do with this thing? - You can open bottles with it.
direkt	Wir wohnen direkt über dem Café.	We live directly above the café.
direkt(2)	Gibt es keinen direkten Zug nach Hamburg? - Nein, Sie müssen immer umsteigen.	Is there no direct train to Hamburg? - No, you always have to change.
direkt(3)	Ich möchte nicht direkt nach der Schule studieren.	 I don’t want to study right after school.
direkt(4)	Ich möchte erst reisen.	 I want to travel first.
direkt(5)	Wir liefern Ihnen das Sofa direkt ins Haus.	We will deliver the sofa directly to your house.
die Disco, -s / die Disko, -s	Wir gehen heute Abend in die Disco/Disko.	We’re going to the disco tonight.
diskutieren	Ich möchte das mit meinen Kollegen diskutieren.	I’d like to discuss this with my colleagues.
hat diskutiert		
doch	Hast du keinen Hunger? - Doch, ich bin sehr hungrig.	Aren’t you hungry? - Yes, I’m very hungry.
doch(2)	Kannst du morgen nicht kommen? - Doch.	Can’t you come tomorrow? - Yes, I can.
doch(3)	Geh doch mal wieder ins Kino!	Why don’t you go to the cinema again!
doch(4)	Das macht doch nichts!	That doesn’t matter!
das Doppelzimmer, -	Möchten Sie ein Doppelzimmer oder ein Einzelzimmer?	Would you like a double room or a single room?
das Dorf, ¨-er	Unser Dorf liegt direkt an der Autobahn.	Our village is right on the highway.
das Dorf(2)	Meine Familie lebt in einem Dorf.	My family lives in a village.
dort, -her, -hin	Wir treffen uns vor dem Kino. - Gut, ich bin in fünf Minuten dort.	We’ll meet in front of the cinema. - Okay, I’ll be there in five minutes.
dort(2)	Dort ist unser Haus.	There is our house.
dort(3)	Deine Tasche kannst du dorthin stellen.	You can put your bag over there.
dort(4)	Kommst du mit in die Stadt? - Nein, ich komme gerade dorther/von dort.	Are you coming to town? - No, I’m coming from there.
draußen	Das Wetter ist so schön. Wollen wir draußen sitzen?	The weather is so nice. Do you want to sit outside?
draußen(2)	Hunde müssen draußen bleiben.	Dogs must stay outside.
dringend	Bitte kommen Sie schnell. Es ist dringend.	Please come quickly. It’s urgent.
drinnen	Wollen Sie drinnen oder draußen sitzen?	Would you like to sit inside or outside?
drinnen(2)	Hier drinnen ist es sehr warm.	It’s very warm in here.
drüben	Da drüben ist die Haltestelle.	The bus stop is over there.
drücken, drückt	An dieser Tür musst du drücken, nicht ziehen, dann geht sie auf.	On this door, you have to push, not pull, and it will open.
drücken(2)	Drücken Sie „Bestätigen“!	Press “Confirm”!
drücken(3)	Meine Schuhe drücken.	My shoes are pressing (hurting).
drucken, druckt	Wähle einfach „Datei drucken“!	Just choose “Print file”!
hat gedruckt		
der Drucker, -	Mein Drucker ist kaputt.	My printer is broken.
dumm	Ich finde den Film dumm.	I find the film dumb.
dumm(2)	Entschuldigung, das war dumm von mir.	Sorry, that was dumb of me.
dumm(3)	Das ist mir zu dumm.	This is too dumb for me.
dunkel	Um sechs Uhr ist es schon dunkel.	It’s already dark at six o’clock.
dunkel(2)	Meine Schwester hat dunkle Haare.	My sister has dark hair.
dunkel(3)	Ich will eine dunkelblaue Bluse kaufen.	I want to buy a dark blue blouse.
dünn	Das Buch ist sehr dünn. Es hat nur 40 Seiten.	The book is very thin. It only has 40 pages.
dünn(2)	Mein Bruder ist 1,80 Meter groß und 62 Kilo schwer, er ist zu dünn.	My brother is 1.80 meters tall and weighs 62 kilos; he is too thin.
durch	Am besten gehen Sie durch die Tengstraße.	It’s best if you go through Tengstraße.
durch(2)	Wir fahren mit dem Fahrrad durch den Wald.	We’re riding through the forest on the bike.
dürfen, darf	Sie dürfen hier nicht parken.	You are not allowed to park here.
dürfen(2)	Dürfen wir heute länger fernsehen?	May we watch TV longer today?
dürfen(3)	Darf ich Sie zu einem Kaffee einladen?	May I invite you to a coffee?
der Durst (Sing.)	Hast du etwas zu trinken? Ich habe großen Durst.	Do you have something to drink? I’m very thirsty.
die Dusche, -n	Unsere Wohnung hat nur eine Dusche.	Our apartment only has a shower.
duschen (sich), duscht	Ich bade nicht so gern, ich dusche lieber.	I don’t like to bathe, I prefer to shower.
duschen (sich)(2)	Möchten Sie sich duschen? Das Badezimmer ist dort hinten links.	Would you like to take a shower? The bathroom is over there on the left.
hat geduscht		
