das E-Book, -s	Liest du lieber E-Books oder Bücher aus Papier?	Do you prefer e-books or paper books?
das E-Book, -s(2)	Entschuldigung, kann man hier E-Books kaufen?	Sorry, can you buy e-books here?
echt	Ist das Bild ein echter Picasso?	Is the painting a real Picasso?
echt(2)	Der Film ist echt gut.	The movie is really good.
die Ecke, -n	Gehen Sie an der nächsten Ecke links. Dann kommen Sie zur Apotheke.	Turn left at the next corner. Then you will get to the pharmacy.
die Ecke, -n(2)	Wir stellen das Regal in die Ecke.	We’re placing the shelf in the corner.
das Einkaufszentrum, -en	Kommst du morgen mit ins Einkaufszentrum?	Are you coming to the shopping center tomorrow?
einladen, lädt ein	Darf ich Sie zu einem Kaffee einladen?	May I invite you to a coffee?
einladen, hat eingeladen(2)	Danke für die Einladung zu deinem Geburtstag!	Thank you for the invitation to your birthday!
einmal	Rufen Sie/Ruf mich bitte morgen noch einmal an.	Please call me again tomorrow.
einmal(2)	Diese Prüfung mache ich nicht noch einmal.	I’m not doing this exam again.
einmal(3)	Warst du schon einmal in Paris?	Have you ever been to Paris?
einpacken	Soll ich Ihnen das als Geschenk einpacken?	Should I wrap this as a gift for you?
packt ein	Pack bitte die Handtücher ein!	Pack the towels, please!
hat eingepackt		
einsteigen	Bitte ab 20 Uhr vorn im Bus einsteigen.	Please board the bus at the front from 8 PM.
steigt ein	Schnell, steig ein, der Zug fährt gleich ab.	Hurry, get in, the train is about to leave.
ist eingestiegen		
eintragen (sich) 	Sie müssen Ihren Namen und Ihre Adresse eintragen.	You need to enter your name and address.
trägt ein	Tragen Sie sich bitte in diese Liste ein!	Please sign up on this list!
hat eingetragen		
der Eintritt, -e	Der Eintritt kostet fünf Euro.	The entrance fee is five euros.
der Eintritt, -e(2)	Der Eintritt ist frei. Sie müssen nichts bezahlen.	Entrance is free. You don’t have to pay anything.
einverstanden sein	Als Termin schlage ich den 11. Juni vor. - Gut, (ich bin) einverstanden.	I suggest June 11th as the date. - Good, I agree.
einverstanden sein(2)	Bist du einverstanden, wenn wir bald nach Hause gehen?	Are you okay if we go home soon?
einzel-	Nicht alle zusammen. Könnt ihr bitte einzeln sprechen?	Not all together. Can you please speak individually?
einzel-(2)	Florian ist ein Einzelkind. Er hat keine Geschwister.	Florian is an only child. He has no siblings.
einzel-(3)	Ein Einzelzimmer ist noch frei.	A single room is still available.
einziehen	Wann können wir in die Wohnung einziehen?	When can we move into the apartment?
zieht ein	Im Juni ziehen unsere neuen Nachbarn ein.	In June, our new neighbors are moving in.
ist eingezogen		
egal	Das ist mir egal.	I don’t care.
egal(2)	Willst du Tee oder Kaffee trinken? – Egal.	Do you want to drink tea or coffee? – It doesn’t matter.
die Ehefrau, -en / der Ehemann, -er	Das ist mein Ehemann/meine Ehefrau.	This is my husband/my wife.
das Ei, -er	Möchtest du ein Ei zum Frühstück?	Would you like an egg for breakfast?
eigen-	Nicht alle Kinder haben ein eigenes Zimmer.	Not all children have their own room.
eigentlich(1)	Wir wollten eigentlich Freunde besuchen, aber dann sind wir doch zu Hause geblieben.	We actually wanted to visit friends, but then we stayed home.
eigentlich(2)	Kennst du eigentlich Susanne?	Do you actually know Susanne?
das Eis (Sg.)	Möchtest du auch ein Eis?	Would you like an ice cream, too?
die (E-)Mail, -s	Ich schreibe Ihnen/dir eine E-Mail.	I’m writing you an email.
der Empfänger, –	Auf dem Brief steht dein Name, also bist du der Empfänger.	The letter has your name on it, so you are the recipient.
empfehlen	Welchen Wein können Sie mir empfehlen?	Which wine can you recommend to me?
empfiehlt		
hat empfohlen		
das Ende, -n	Sie wohnt am Ende der Straße.	She lives at the end of the street.
das Ende, -n(2)	Er bekommt sein Geld am Monatsende.	He gets his money at the end of the month.
eilig	Hast du es eilig?	Are you in a hurry?
einfach	Die Prüfung ist ganz einfach.	The exam is quite simple.
einfach(2)	Ich verstehe das nicht. Kannst du es bitte einfacher sagen?	I don’t understand that. Can you please say it more simply?
einfach(3)	Hin und zurück? – Nein, bitte nur eine einfache Fahrt nach Berlin.	Round trip? – No, just a one-way trip to Berlin, please.
der Eingang, ¨-e	Der Eingang ist um die Ecke.	The entrance is around the corner.
einig-	In diesem Text sind einige Fehler.	There are some mistakes in this text.
einig-(2)	Das dauert noch einige Zeit, bis das Essen fertig ist.	It will take some time until the food is ready.
einkaufen	Ich muss noch für morgen einkaufen.	I still need to shop for tomorrow.
kauft ein		
hat eingekauft		
enden, endet	Die Straße endet hier.	The street ends here.
enden, hat geendet	Der Kurs endet in einer Woche.	The course ends in a week.
endlich	Wann kommst du endlich? Der Film fängt gleich an.	When are you finally coming? The movie is about to start.
endlich(2)	Endlich bist du da!	You’re finally here!
eng	Diese Hose ist zu eng. Gibt es sie auch eine Nummer größer?	This pair of pants is too tight. Is there a larger size?
entschuldigen (sich)	Entschuldigen Sie bitte!	Excuse me, please!
entschuldigen (sich)	Ich möchte mich bei dir entschuldigen.	I want to apologize to you.
entschuldigt		
hat entschuldigt		
die Entschuldigung, -en	Oh, Entschuldigung! – Macht nichts. Kein Problem.	Oh, excuse me! - That’s okay. No problem.
das Erdgeschoss, -e	Ich wohne im Erdgeschoss.	I live on the ground floor.
die Erfahrung, -en	Ich habe zehn Jahre Erfahrung in diesem Beruf.	I have ten years of experience in this profession.
erinnern (sich),	Erinnerst du dich an José? - Nein, ich erinnere mich nicht an ihn, tut mir leid.	Do you remember José? - No, I don’t remember him, I’m sorry.
erinnert		
hat erinnert		
erkältet sein	Lisa ist erkältet. Sie kann heute nicht zur Schule gehen.	Lisa has a cold. She can’t go to school today.
ist erkältet		
war erkältet		
ist erkältet gewesen		
erklären, erklärt	Ich verstehe das nicht. Kannst du mir das erklären?	I don’t understand that. Can you explain it to me?
erlauben, erlaubt	Meine Kinder dürfen diesen Film sehen. Ich habe es ihnen erlaubt.	My children are allowed to watch this movie. I have permitted it.
hat erlaubt		
erlaubt sein, ist erlaubt	Parken ist hier nicht erlaubt.	Parking is not allowed here.
war erlaubt		
ist erlaubt gewesen		
die Erlaubnis (Sg.)	Haben Sie eine Arbeitserlaubnis?	Do you have a work permit?
die Ermäßigung, -en	Für Schüler, Studenten und Rentner gibt es eine Ermäßigung.	There is a discount for students, pupils, and retirees.
erreichen	Wenn wir uns beeilen, erreichen wir noch den Zug um acht Uhr.	If we hurry, we’ll still catch the train at eight o’clock.
erreichen(2)	Bis 18 Uhr können Sie mich im Büro erreichen.	You can reach me at the office until 6 PM.
erreicht		
hat erreicht		
erst	Wir können erst morgen kommen.	We can only come tomorrow.
erst(2)	Dina ist keine 18, sie ist erst 16 Jahre alt.	Dina is not 18, she is only 16 years old.
der Erwachsene, -n	Erwachsene zahlen zehn Euro, für Kinder ist der Eintritt frei.	Adults pay ten euros, for children the entrance is free.
der Erwachsene, -n(2)	Dieser Film ist nur für Erwachsene.	This film is only for adults.
erzählen, erzählt	Wir müssen euch etwas erzählen!	We have to tell you something!
erzählen, hat erzählt(2)	Erzählst du mir eine Geschichte?	Will you tell me a story?
essen, isst	Was gibt es zu essen?	What is there to eat?
essen, hat gegessen(2)	Das Essen in der Cafeteria ist meistens ganz gut.	The food in the cafeteria is usually quite good.
essen, hat gegessen(3)	Darf ich Sie zum Essen einladen?	May I invite you to a meal?
etwas	Ich muss dir etwas erzählen!	I need to tell you something!
etwas(2)	Haben Sie etwas zum Schreiben?	Do you have something to write with?
etwas(3)	Ich habe leider nur Tee. Etwas anderes kann ich dir leider nicht anbieten.	I only have tea. Unfortunately, I can’t offer you anything else.
