german word	german sentence	english translation
das Paar, -e	Romeo und Julia sind ein Paar.	Romeo and Juliet are a couple.
das Paar, -e(2)	Ich brauche ein Paar Schuhe.	I need a pair of shoes.
ein paar	Wir fahren ein paar Tage ans Meer.	We’re going to the sea for a few days.
ein paar(2)	Hast du ein paar Minuten Zeit?	Do you have a few minutes?
packen, packt, hat gepackt	Ich muss noch meinen Koffer packen.	I still need to pack my suitcase.
packen, packt, hat gepackt(2)	Das Paket ist noch nicht gepackt.	The package is not packed yet.
das Paket, -e	Bringst du bitte das Paket zur Post?	Could you please take the package to the post office?
das Papier, -e	Hier sind Papier und Bleistift.	Here are paper and pencil.
die Papiere (Pl.)	Haben Sie Ihre Papiere dabei?	Do you have your documents with you?
das Parfüm, -s	Ich suche ein Parfum als Geschenk für meine Frau.	I’m looking for a perfume as a gift for my wife.
der Park, -s	Ich gehe gern im Park spazieren.	I like to walk in the park.
parken, parkt, hat geparkt	Darf ich hier parken?	May I park here?
parken, parkt, hat geparkt(2)	Hier ist Parken verboten. 	Parking is prohibited here.
der Partner, -	Veronika ist meine Partnerin.	Veronika is my partner.
die Partnerin, -nen	Veronika ist meine Partnerin.	Veronika is my partner.
die Party, -s	Heute Abend machen wir eine Party.	We’re having a party this evening.
der Pass, ¨-e	Am Flughafen brauchst du deinen Pass.	You need your passport at the airport.
passen, passt, hat gepasst	Die Bluse passt mir nicht.	The blouse doesn’t fit me.
passen, passt, hat gepasst(2)	Welches Wort passt? Wählen Sie.	Which word fits? Choose.
passieren, passiert, ist passiert	Wie ist der Unfall passiert?	How did the accident happen?
passieren, passiert, ist passiert(2)	Was ist passiert?	What happened?
das Passwort, ¨-er	Bitte schreiben Sie Ihr Passwort.	Please write your password.
das Passwort, ¨-er(2)	Sie brauchen ein Passwort.	You need a password.
das Passwort, ¨-er(3)	Ich habe mein Passwort vergessen.	I forgot my password.
die Pause, -n	Von 12.00 bis 12.30 Uhr haben wir Mittagspause.	We have lunch break from 12:00 to 12:30.
die Person, -en	Eintritt pro Person: 5 Euro.	Admission per person: 5 euros.
das Pferd, -e	Amira liebt Pferde. Sie reitet seit zehn Jahren.	Amira loves horses. She has been riding for ten years.
die Pflanze, -n	Können Sie sich bitte um unsere Pflanzen kümmern? Wir sind nächste Woche im Urlaub.	Could you please take care of our plants? We’re on vacation next week.
die Pizza, -s/-en	Mein Lieblingsessen ist Pizza.	My favorite food is pizza.
die Pizza, -s/-en(2)	Eine Pizza mit viel Käse, bitte.	A pizza with a lot of cheese, please.
das Plakat, -e	Wir machen im Unterricht ein Plakat zum Thema „Essen und Trinken“.	We’re making a poster on the topic “Food and Drink” in class.
der Plan, ¨-e	Ich kaufe mir einen Stadtplan.	I’m buying a city map.
planen, plant, hat geplant	Wir sollen zusammen eine Klassenparty planen.	We should plan a class party together.
planen, plant, hat geplant(2)	Morgen schwimmen ... ist ein guter Plan.	Swimming tomorrow ... is a good plan.
der Platz, ¨-e	Hier ist noch ein Platz frei.	There is still a seat free here.
der Platz, ¨-e(2)	Bitte nehmen Sie Platz!	Please take a seat!
der Platz, ¨-e(3)	Ich wohne am Messeplatz 5.	I live at Messeplatz 5.
der Platz, ¨-e(4)	Ich finde keinen Parkplatz.	I can’t find a parking space.
plötzlich	Plötzlich war das Licht aus.	Suddenly, the light was out.
die Polizei (Sg.)	Rufen Sie die Polizei!	Call the police!
die Pommes frites (Pl.)	Die Kinder essen Bratwurst mit Pommes frites.	The kids are eating sausages with French fries.
die Portion, -en	Ich nehme eine kleine Portion Eis.	I’ll have a small portion of ice cream.
die Post (Sg.)	Entschuldigung, wo ist die Post?	Excuse me, where is the post office?
die Post (Sg.) (2)	Ist Post für mich da?	Is there mail for me?
das Poster, -	Das Poster hängt über dem Bett.	The poster is hanging above the bed.
die Postkarte, -n	Schreibst du mir eine Postkarte aus Kanada?	Will you write me a postcard from Canada?
die Postleitzahl, -en	Wie ist Ihre Postleitzahl?	What is your postal code?
das Praktikum, -a	Ich mache ein Praktikum bei Siemens.	I’m doing an internship at Siemens.
praktisch	Mit meinem neuen Handy kann ich auch im Internet surfen und Fotos machen. Das finde ich sehr praktisch.	My new phone lets me surf the internet and take photos. I find it very practical.
die Praxis, -en	Unsere Praxis ist ab acht Uhr geöffnet. Frau Doktor Weiß hat ab neun Uhr Sprechstunde.	Our practice is open from eight o’clock. Dr. Weiß has office hours from nine o’clock.
der Preis, -e	Die Preise sind hier viel höher als bei uns.	The prices are much higher here than at home.
preiswert	Die Jacke ist sehr preiswert. Sie kostet nur 15 Euro.	The jacket is very inexpensive. It costs only 15 euros.
privat	Das ist meine Nummer im Büro und das ist meine private Handynummer.	This is my office number and this is my private cell phone number.
privat(2)	Dieser Strand ist privat. Wir dürfen hier nicht schwimmen gehen.	This beach is private. We are not allowed to swim here.
privat(3)	Hey, du darfst die Mail nicht lesen! Sie ist privat.	Hey, you’re not allowed to read the email! It’s private.
pro	Das Zimmer kostet 100 Euro pro Nacht.	The room costs 100 euros per night.
probieren, probiert, hat probiert	Möchten Sie den Käse probieren?	Would you like to try the cheese?
probieren, probiert, hat probiert(2)	Die Tür geht schwer auf. Probier mal!	The door is hard to open. Try it!
das Problem, -e	Ich habe ein Problem. Können Sie mir bitte helfen?	I have a problem. Can you please help me?
das Produkt, -e	Unsere Produkte haben eine sehr hohe Qualität.	Our products have very high quality.
das Programm, -e	Dieses Programm im Radio interessiert mich nicht.	This program on the radio doesn’t interest me.
das Programm, -e(2)	Was kommt heute im Kino? Hast du das Programm hier?	What’s on at the cinema today? Do you have the program here?
das Projekt, -e	Wir machen ein Projekt über Sehenswürdigkeiten in unserer Stadt.	We are working on a project about landmarks in our city.
der Prospekt, -e	Bitte schicken Sie mir einen Prospekt von Ihrem Hotel.	Please send me a brochure from your hotel.
prüfen, prüft, hat geprüft	Bitte prüfen Sie die Rechnung sofort.	Please check the invoice immediately.
die Prüfung, -en	Ich habe die Prüfung bestanden.	I passed the exam.
der Pullover, -	Ich muss mir einen Pullover kaufen.	I need to buy a sweater.
pünktlich	Der Bus fährt pünktlich um acht Uhr.	The bus departs punctually at eight o’clock.
pünktlich(2)	Herr Müller ist immer pünktlich.	Mr. Müller is always punctual.
putzen, putzt, hat geputzt	Ich muss heute noch das Bad putzen.	I need to clean the bathroom today.
