german word	german sentence	english translation
die Zahl, -en	Können Sie die Zahl bitte wiederholen?	Can you please repeat the number?
zahlen, zahlt	Entschuldigung, zahlen bitte!	Excuse me, the bill please!
zahlen, zahlt (2)	Er hat gezahlt.	He paid.
der Zahn, ¨-e	Der Zahn tut mir schon seit einer Woche weh.	My tooth has been hurting for a week.
zeichnen, zeichnet	Caterina kann gut zeichnen. Sieh mal das Bild hier.	Caterina can draw well. Look at this picture here.
zeichnen, zeichnet (2)	Sie hat das Bild gezeichnet.	She drew the picture.
zeigen, zeigt	Können Sie mir bitte den Weg zum Bahnhof zeigen?	Can you please show me the way to the train station?
zeigen, zeigt (2)	Er hat mir sein neues Auto gezeigt.	He showed me his new car.
die Zeit, -en	Ich habe heute keine Zeit.	I don’t have time today.
die Zeitschrift, -en	Diese Zeitschrift kauft Andrea jede Woche.	Andrea buys this magazine every week.
die Zeitung, -en	Ich lese manchmal Zeitung.	I sometimes read the newspaper.
die Zeitung, -en (2)	Wo ist die Zeitung von heute?	Where is today's newspaper?
das Zelt, -e	Im Sommer schlafen wir manchmal im Zelt.	In the summer, we sometimes sleep in a tent.
das Zentrum, -en	Der Bahnhof ist im Stadtzentrum.	The train station is in the city center.
das Zentrum, -en (2)	Wohnst du im Zentrum? – Nein, ich wohne nicht direkt in der Stadt.	Do you live in the center? - No, I don't live directly in the city.
der Zettel, -	Hast du einen Zettel für mich? Ich muss etwas notieren.	Do you have a piece of paper for me? I need to jot something down.
der Zettel, - (2)	Schreiben Sie Ihre Telefonnummer bitte auf den Zettel.	Please write your phone number on the note.
das Zeugnis, -se	Morgen bekommen die Kinder ihr Zeugnis.	The children will get their report card tomorrow.
(an-)/(aus)ziehen, zieht (an/aus)	Ich ziehe (mir) eine Jacke an.	I am putting on a jacket.
(an-)/(aus)ziehen, zieht (an/aus) (2)	Er hat sein T-Shirt ausgezogen und ein Hemd angezogen.	He took off his T-shirt and put on a shirt.
(an-)/(aus)ziehen, hat/ist (an/aus)gezogen	Die Nachbarn sind am Wochenende ausgezogen.	The neighbors moved out over the weekend.
das Ziel, -e	John läuft sehr schnell. Er war als erster am Ziel.	John runs very fast. He was the first at the finish line.
das Ziel, -e (2)	Was ist dein Ziel im Leben?	What is your goal in life?
das Zimmer, -	Das Zimmer ist am größten.	The room is the largest.
das Zimmer, - (2)	Mach im Schlafzimmer das Fenster zu!	Close the window in the bedroom!
das Zimmer, - (3)	Die Wohnung hat drei Zimmer.	The apartment has three rooms.
das Zimmer, - (4)	Ich habe im Hotel ein Zimmer bestellt.	I booked a room in the hotel.
der Zirkus, -se	Heute gehen wir mit den Kindern in den Zirkus.	Today we are going to the circus with the children.
die Zitrone, -n	Ich trinke den Tee mit Zitrone.	I drink tea with lemon.
die Zitrone, -n (2)	Lucia mag Zitroneneis.	Lucia likes lemon ice cream.
der Zoo, -s	Am Sonntag gehen wir in den Zoo.	On Sunday, we are going to the zoo.
zu	Der Bus fährt zum Bahnhof.	The bus goes to the train station.
zu (2)	Ich gehe zu Fuß.	I go on foot.
zu (3)	Ich bin zu Hause.	I am at home.
zu (4)	Das Kleid ist mir zu teuer.	The dress is too expensive for me.
zu (5)	Ich trinke zum Essen ein Bier.	I drink beer with my meal.
der Zucker (Sg.)	Trinken Sie den Tee mit oder ohne Zucker?	Do you drink tea with or without sugar?
zuerst	Zuerst müsst ihr die Hausaufgaben machen, dann könnt ihr spielen.	First you have to do your homework, then you can play.
zuerst (2)	Zuerst hat mir die Arbeit gar nicht gefallen. Jetzt geht es besser.	At first I didn't like the work at all. Now it's getting better.
zufrieden	Ich bin mit der Wohnung zufrieden. Sie ist nicht groß, aber sie hat einen Balkon.	I am satisfied with the apartment. It is not big, but it has a balcony.
der Zug, ¨-e	Ich fahre gern mit dem Zug.	I like traveling by train.
zuhören, hört zu	Hör mir doch mal zu! Ich rede mit dir.	Listen to me! I am talking to you.
zuhören, hört zu (2)	Er hat mir nicht zugehört.	He didn’t listen to me.
zuletzt	Wir haben uns vor drei Jahren zuletzt gesehen.	We last saw each other three years ago.
zuletzt (2)	Diese Aufgabe machen wir zuletzt.	We will do this task last.
zum Beispiel	Mein Freund hat viele Hobbys, zum Beispiel Kochen, Lesen und Tanzen.	My friend has many hobbies, for example, cooking, reading, and dancing.
zumachen, macht zu	Machst du bitte das Fenster zu?	Can you please close the window?
zumachen, macht zu (2)	Er hat die Tür zugemacht.	He closed the door.
zurück	Eine Fahrkarte nach Frankfurt und zurück, bitte.	A ticket to Frankfurt and back, please.
zurück- (fahren, geben, gehen, kommen, laufen)	Fahrt ihr nach der Party zurück nach Hause?	Are you driving back home after the party?
zurück- (fahren, geben, gehen, kommen, laufen) (2)	Wann muss ich das Buch zurückgeben?	When do I have to return the book?
zurück- (fahren, geben, gehen, kommen, laufen) (3)	Wir gehen wieder zurück.	We are going back again.
zurück- (fahren, geben, gehen, kommen, laufen) (4)	Wann kommst du zurück?	When are you coming back?
zurück- (fahren, geben, gehen, kommen, laufen) (5)	Ich habe mein Buch vergessen. Ich laufe schnell nach Hause zurück.	I forgot my book. I’ll quickly run back home.
zusammen	Wollen wir zusammen essen gehen?	Shall we go out to eat together?
zusammen (2)	Zahlen, bitte. – Zusammen oder getrennt?	The bill, please. – Together or separate?
zusammen (3)	Das macht zusammen 10 Euro 80.	That will be 10 euros 80 altogether.
zwischen	Heidelberg liegt zwischen Frankfurt und Stuttgart.	Heidelberg is between Frankfurt and Stuttgart.
zwischen (2)	Zwischen acht und zehn Uhr bin ich zu Hause.	I’ll be at home between eight and ten o'clock.

