german word	german sentence	english translation
eben(1)	Ich bin eben erst angekommen.	I just arrived.
eben(2)	Ich gebe auf. Ich habe eben kein Glück!	I give up. I just have no luck!
ebenfalls(1)	Ich wünsche Ihnen ein schönes Wochenende. – Danke, ebenfalls.	I wish you a nice weekend. – Thank you, likewise.
ebenso(1)	Schöne Feiertage. – Danke, ebenso.	Happy holidays. – Thank you, likewise.
die e-card(1)	Haben Sie Ihre e-card dabei?	Do you have your e-card with you?
echt(1)	Ich träume von einem echten Perserteppich.	I dream of a real Persian rug.
echt(2)	Der Film war echt gut.	The movie was really good.
eilen(1)	Es eilt sehr. Bitte machen Sie schnell.	It’s very urgent. Please hurry.
eilen(2)	Es eilt sehr. Bitte machen Sie schnell.	It’s very urgent. Please hurry.
die Eile(1)	Ich bin sehr in Eile.	I am very rushed.
die Eile(2)	Das hat keine Eile.	That is not urgent.
eilig(1)	Hast du es eilig?	Are you in a hurry?
die ec-Karte/EC-Karte(1)	Bezahlen Sie bar? Sie können auch mit der ec-Karte zahlen.	Do you pay in cash? You can also pay with the EC card.
die Ecke(1)	Das Regal stellen wir hier in die Ecke.	We’ll put the shelf here in the corner.
die Ecke(2)	Das bekommen Sie im Kiosk an der Ecke.	You can get that at the kiosk at the corner.
die Ecke(3)	Wo ist die Apotheke? − Gleich um die Ecke.	Where is the pharmacy? − Just around the corner.
das Eck(1)	Das Regal stellen wir hier ins Eck.	We’ll put the shelf here in the corner.
das Eck(2)	Das bekommen Sie im Kiosk am Eck.	You can get that at the kiosk at the corner.
das Eck(3)	Wo ist die Apotheke? − Gleich ums Eck.	Where is the pharmacy? − Just around the corner.
eckig(1)	Ich möchte einen eckigen Tisch, keinen runden.	I want a square table, not a round one.
egal(1)	Es ist mir ganz egal, was die Leute denken.	I don’t care what people think.
egal(2)	Egal, wie das Wetter ist, ich gehe schwimmen.	No matter how the weather is, I will go swimming.
ein-(1)	Ich nehme ein Bier. Willst du auch eins?	I’ll have a beer. Do you want one too?
ein-(2)	Wir haben zu wenig Mitspieler. Wir brauchen noch einen.	We don’t have enough players. We need one more.
die Einbahnstraße(1)	Die Goethestraße ist jetzt eine Einbahnstraße.	Goethe Street is now a one-way street.
einbrechen(1)	Jemand ist in unsere Wohnung eingebrochen.	Someone broke into our apartment.
einbrechen(2)	Jemand ist in unsere Wohnung eingebrochen.	Someone broke into our apartment.
der Einbrecher(1)	Die Einbrecher haben nichts gestohlen.	The burglars didn’t steal anything.
die Einbrecherin(1)	Die Einbrecher haben nichts gestohlen.	The burglars didn’t steal anything.
der Einbruch(1)	In der Urlaubszeit gibt es viele Wohnungseinbrüche.	During the vacation season, there are many burglaries.
eindeutig(1)	Das Ergebnis ist eindeutig. Du hast gewonnen.	The result is clear. You won.
die Ehe(1)	Sie hat zwei Kinder aus erster Ehe.	She has two children from her first marriage.
die Ehefrau(1)	Wie heißt Ihre Ehefrau mit Vornamen?	What is your wife’s first name?
der Ehemann(1)	Wie heißt Ihre Ehefrau mit Vornamen?	What is your wife’s first name?
das Ehepaar(1)	Das Ehepaar unter uns hat zwei Kinder.	The couple below us has two children.
eher(1)	Ich stehe meist eher auf als mein Mann.	I usually get up earlier than my husband.
eher(2)	Michael sieht gerne Serien, ich mag eher Krimis.	Michael likes series, I prefer crime stories.
ehrlich(1)	Sie ist ein ehrlicher Mensch.	She is an honest person.
ehrlich(2)	Bitte sei in dieser Sache ehrlich.	Please be honest about this.
ehrlich(3)	Die Pause haben wir uns ehrlich verdient.	We honestly deserved the break.
das Ei(1)	Möchtest du zum Frühstück ein Ei?	Would you like an egg for breakfast?
eigen-(1)	Fast jedes Kind hat ein eigenes Zimmer.	Almost every child has their own room.
eigen-(2)	Manche Leute haben keine eigene Meinung.	Some people don’t have their own opinion.
eigentlich(1)	Wir wollten eigentlich Freunde besuchen, aber dann sind wir doch zu Hause geblieben.	We originally wanted to visit friends, but then we stayed at home.
eigentlich(2)	Die Sängerin nennt sich Arabella. Aber eigentlich heißt sie Uschi Müller.	The singer calls herself Arabella. But her real name is Uschi Müller.
eigentlich(3)	Was willst du eigentlich von mir?	What do you actually want from me?
sich eignen(1)	Dieses Hotel eignet sich besonders für Familien mit Kindern.	This hotel is particularly suitable for families with children.
der Eindruck(1)	Ich finde die Leute auf der Straße ziemlich unfreundlich. Wie ist dein Eindruck?	I find the people on the street quite unfriendly. What is your impression?
der Eindruck(2)	Ich glaube, ich habe bei dem Vorstellungsgespräch einen guten Eindruck gemacht.	I think I made a good impression at the job interview.
einerseits(1)	Einerseits möchte ich die Reise gern machen, andererseits ist sie zu teuer.	On one hand, I would like to go on the trip, but on the other hand, it is too expensive.
einfach(1)	Hin und zurück? – Nein, bitte nur einfach.	Round trip? – No, just one way please.
einfach(2)	Ich verstehe das nicht. Kannst du das bitte einfacher sagen?	I don’t understand. Can you please say that more simply?
einfach(3)	Wir haben am Wochenende einen Ausflug gemacht. Es war einfach toll.	We went on an excursion over the weekend. It was simply great.
die Einfahrt(1)	Da parkt wieder jemand vor unserer Einfahrt.	Someone is parking in front of our driveway again.
die Einfahrt(2)	Können Sie nicht lesen: Einfahrt freihalten!	Can’t you read: Keep the driveway clear!
einfallen(1)	Mir ist wieder eingefallen, wie das Buch heißt.	I just remembered the name of the book.
einfallen(2)	Mir ist wieder eingefallen, wie das Buch heißt.	I just remembered the name of the book.
der Einfall(1)	Frag einfach meine Freundin. Sie hat immer gute Einfälle.	Just ask my friend. She always has good ideas.
der Einfluss(1)	Das Wetter hat Einfluss auf die Gesundheit der Menschen.	The weather has an impact on people’s health.
beeinflussen(1)	Dieses Ereignis hat die Wahlen beeinflusst.	This event influenced the elections.
einfügen(1)	Markieren Sie zuerst die Zeilen, dann „kopieren“ drücken und dann einfügen.	First select the lines, then press “copy” and then paste.
einführen(1)	Dürfen wir diese Ware ins Land einführen?	Are we allowed to import this goods into the country?
einführen(2)	Wir haben letztes Jahr ein neues System eingeführt.	We introduced a new system last year.
die Einführung(1)	Leider habe ich die Einführung des Kurses verpasst.	Unfortunately, I missed the introduction of the course.
der Eingang(1)	Das Gebäude hat zwei Eingänge.	The building has two entrances.
der Eingang(2)	Der Eingang ist um die Ecke.	The entrance is around the corner.
einheitlich(1)	Die Schüler dieser Schule tragen einheitliche Kleidung.	The students at this school wear uniform clothing.
einig-(1)	In diesem Bericht sind einige Fehler.	There are a few errors in this report.
einig-(2)	Das wird noch einige Zeit dauern.	This will take some time.
einig-(3)	Einige Leute sind für das Gesetz, aber viele sind auch dagegen.	Some people are for the law, but many are also against it.
sich einigen(1)	Jeder hat einen anderen Vorschlag. Wir können uns leider nicht einigen.	Everyone has a different suggestion. Unfortunately, we cannot agree.
einkaufen(1)	Wir gehen einmal pro Woche einkaufen.	We go shopping once a week.
der Einkauf(1)	Achten Sie beim Einkauf auf Sonderangebote.	Pay attention to special offers when shopping.
der Einkauf(2)	Ich habe alle Einkäufe erledigt. Jetzt können wir einen Kaffee trinken.	I have finished all the shopping. Now we can have a coffee.
das Einkommen(1)	Bei einem höheren Einkommen muss man mehr Steuern zahlen.	With a higher income, you have to pay more taxes.
einladen(1)	Darf ich Sie zum Essen einladen?	May I invite you to dinner?
die Einladung(1)	Danke für die Einladung.	Thank you for the invitation.
einmal(1)	Ich habe diese Oper leider nur einmal gesehen.	Unfortunately, I have only seen this opera once.
einmal(2)	Bitte rufen Sie morgen noch einmal an.	Please call again tomorrow.
einmal(3)	Auf einmal ging das Licht aus.	Suddenly the lights went out.
einmal(4)	Ich kann nicht alles auf einmal machen.	I can’t do everything at once.
einmal(5)	Sehen wir uns (ein)mal wieder?	Shall we see each other again?
einmal(6)	Vor Jahren habe ich (ein)mal in Wien gewohnt.	Years ago, I once lived in Vienna.
einmal(7)	Komm doch bitte (ein)mal her und hilf mir.	Please come over here and help me.
einnehmen(1)	Wie muss ich die Tropfen einnehmen?	How should I take the drops?
die Einnahme(1)	Unser Geschäft läuft gut. Unsere Einnahmen waren in diesem Monat höher als im letzten.	Our business is doing well. Our revenue was higher this month than last month.
einpacken(1)	Hast du Handtücher eingepackt?	Did you pack the towels?
einpacken(2)	Soll ich Ihnen das als Geschenk einpacken?	Should I wrap this as a gift for you?
einrichten(1)	Ich habe meine Wohnung selbst eingerichtet.	I furnished my apartment myself.
einrichten(2)	Wenn Sie Fragen haben, rufen Sie uns an. Wir haben eine extra Telefonnummer eingerichtet.	If you have any questions, call us. We have set up an extra phone number.
die Einrichtung(1)	Deine Wohnung ist sehr gemütlich, die Einrichtung gefällt mir sehr gut.	Your apartment is very cozy, I really like the furnishings.
einsam(1)	Ohne meine Familie fühle ich mich ein bisschen einsam.	Without my family, I feel a bit lonely.
einschalten(1)	Können Sie bitte die Heizung einschalten?	Can you please turn on the heating?
einschließlich(1)	Alles zusammen kostet 200 Euro einschließlich Fahrtkosten.	Everything together costs 200 euros including travel expenses.
das Einschreiben(1)	Ich habe den Brief als Einschreiben geschickt.	I sent the letter by registered mail.
einsetzen(1)	Ich glaube, wir müssen jemanden einsetzen, der sich um die Organisation kümmert.	I think we need to assign someone to take care of the organization.
einsetzen(2)	Peter hat sich dafür eingesetzt, dass ich den Job bekomme.	Peter advocated for me to get the job.
einsteigen(1)	Ab 20 Uhr vorne beim Fahrer einsteigen.	Get in at the front with the driver after 8 PM.
einsteigen(2)	Steig ein. Wir wollen losfahren.	Get in. We want to leave.
einstellen(1)	Die Firma wird in diesem Jahr drei neue Leute einstellen.	The company will hire three new people this year.
einstellen(2)	Das Gerät ist nicht richtig eingestellt.	The device is not set correctly.
eintragen(1)	Tragen Sie sich bitte in die Liste ein.	Please enter your name in the list.
eintreten(1)	Letztes Jahr bin ich in einen Sportverein eingetreten.	Last year, I joined a sports club.
der Eintritt(1)	Kinder über 10 Jahre zahlen den vollen Eintritt.	Children over 10 years old pay the full admission.
der Eintritt(2)	Der Eintritt ist frei.	Admission is free.
einverstanden(1)	Als Termin schlage ich den 3. Mai vor. – Gut, einverstanden!	I propose May 3rd as the date. – Okay, agreed!
einverstanden(2)	Bist du einverstanden, wenn wir bald nach Hause gehen?	Do you agree if we go home soon?
der Einwohner(1)	Berlin hat über drei Millionen Einwohner.	Berlin has over three million inhabitants.
die Einwohnerin(1)	Berlin hat über drei Millionen Einwohner.	Berlin has over three million inhabitants.
einzahlen(1)	Ich habe gestern Geld auf mein Bankkonto eingezahlt.	I deposited money into my bank account yesterday.
einzahlen(2)	Sie sollten die Einzahlung pünktlich machen.	You should make the deposit on time.
die Einzahlung(1)	Sie sollten die Einzahlung pünktlich machen.	You should make the deposit on time.
einzeln(1)	Dieses Mineralwasser gibt es nur als Sechserpack, nicht einzeln.	This mineral water is only available in a six-pack, not individually.
einzeln(2)	Die Schüler mussten einzeln zum Schularzt kommen.	The students had to see the school doctor individually.
einzeln(3)	z. B. Einzelkind, Einzelzimmer	e.g. only child, single room
die Einzelheit(1)	Du musst mir das in allen Einzelheiten erzählen.	You need to tell me all the details.
einzig-(1)	Wir waren die einzigen Gäste.	We were the only guests.
einzig-(2)	Das war das einzige Mal, dass ich ihn gesehen habe.	That was the only time I saw him.
einziehen(1)	Die Wohnung ist fertig. Wir können nächste Woche einziehen.	The apartment is ready. We can move in next week.
das Eis(1)	Im Winter gibt es Eis und Schnee.	In winter, there is ice and snow.
das Eis(2)	Bitte eine Cola ohne Eis.	Please a cola without ice.
das Eis(3)	Zum Nachtisch gibt es Schokoladeneis.	For dessert, there is chocolate ice cream.
die Eisenbahn(1)	Die Kinder wünschen sich eine elektrische Eisenbahn.	The children want an electric train set.
elegant(1)	Ich finde dein Kleid sehr elegant.	I find your dress very elegant.
elektrisch(1)	Wir kochen nicht mit Gas, sondern elektrisch.	We cook with electricity, not gas.
elektronisch(1)	Wir sollten die Daten elektronisch bearbeiten, sonst dauert es zu lange.	We should process the data electronically, otherwise it will take too long.
die Eltern(1)	Ich wohne noch bei meinen Eltern.	I still live with my parents.
empfangen(1)	Wir können mit unserem Fernseher über 30 Programme empfangen.	We can receive over 30 channels with our TV.
empfangen(2)	Die Gäste wurden sehr herzlich empfangen.	The guests were warmly received.
enden(1)	Die Straße endet hier.	The street ends here.
enden(2)	Das Arbeitsverhältnis endet im Mai.	The employment relationship ends in May.
das Ende(1)	Ich wohne am Ende der Straße.	I live at the end of the street.
das Ende(2)	Die nächste Prüfung findet Ende August statt.	The next exam will take place at the end of August.
das Ende(3)	Rinaldo ist Ende fünfzig.	Rinaldo is in his late fifties.
das Ende(4)	Am Dienstag gehen die Ferien zu Ende.	The holidays end on Tuesday.
endgültig(1)	Damit ist das Problem endgültig gelöst.	With that, the problem is definitively solved.
endgültig(2)	Der endgültige Termin steht noch nicht fest.	The final date has not yet been set.
endgültig(3)	Das Ergebnis ist noch nicht endgültig.	The result is not yet final.
endlich(1)	Endlich haben wir eine schöne Wohnung gefunden.	Finally, we have found a nice apartment.
endlich(2)	Haben Sie sich nun endlich entschieden?	Have you finally decided?
die Energie(1)	Wir müssen Energie sparen.	We need to save energy.
die Energie(2)	Abends habe ich keine Energie mehr, um Sport zu machen.	In the evening, I have no energy left to exercise.
eng(1)	Die Jacke ist mir zu eng.	The jacket is too tight for me.
eng(2)	Wir arbeiten mit dieser Firma eng zusammen.	We work closely with this company.
der Enkel(1)	Alle meine Enkel gehen schon zur Schule.	All my grandchildren are already in school.
die Enkelin(1)	Alle meine Enkel gehen schon zur Schule.	All my grandchildren are already in school.
entdecken(1)	Ich habe in deinem Brief noch ein paar Fehler entdeckt.	I found a few mistakes in your letter.
entfernen(1)	Der Müll muss dringend entfernt werden.	The trash must be removed urgently.
entfernen(2)	Das Hotel liegt etwa 100 m vom Strand entfernt.	The hotel is about 100 meters from the beach.
die Entfernung(1)	Aus dieser Entfernung ist das nicht zu erkennen.	From this distance, it cannot be recognized.
entgegenkommen(1)	Auf dem Weg nach Hause ist mir mein Nachbar entgegengekommen.	On the way home, my neighbor came towards me.
entgegenkommen(2)	Können Sie mir mit dem Preis entgegenkommen?	Can you make a concession on the price?
enthalten(1)	Diese Schokolade enthält nur sehr wenig Zucker.	This chocolate contains very little sugar.
enthalten(2)	Ist die Änderung im Preis enthalten?	Is the change included in the price?
entlang(1)	Gehen Sie diese Straße entlang. Dann kommen Sie direkt zum Bahnhof.	Walk along this street. Then you will come directly to the train station.
entlassen(1)	Die Operation ist gut gelaufen. Wir können Sie nächste Woche aus dem Krankenhaus entlassen.	The operation went well. We can discharge you from the hospital next week.
entlassen(2)	Die Firma hat viele Mitarbeiter entlassen.	The company has laid off many employees.
die Entlassung(1)	Seine Entlassung aus der Firma kam überraschend.	His dismissal from the company came as a surprise.
entscheiden(1)	Das kann ich nicht allein entscheiden, da muss ich erst fragen.	I cannot decide that alone; I need to ask first.
entscheiden(2)	Für welchen Anzug haben Sie sich entschieden?	Which suit did you choose?
die Entscheidung(1)	Diese wichtige Entscheidung möchte ich zuerst mit meinem Mann besprechen.	I want to discuss this important decision with my husband first.
unentschieden(1)	Es steht unentschieden zwischen den beiden Mannschaften.	It is a draw between the two teams.
unentschieden(2)	Ich bin noch immer unentschieden, was ich morgen tun soll.	I am still undecided about what to do tomorrow.
sich entschließen(1)	Mein Nachbar hat sich nun doch entschlossen, sein Auto zu verkaufen.	My neighbor has finally decided to sell his car.
sich entschließen(2)	Ich bin fest entschlossen, diese Ausbildung fertigzumachen.	I am determined to complete this training.
entschuldigen(1)	Entschuldigen Sie bitte, dass ich Sie störe. Aber es gibt ein Problem.	Please excuse me for bothering you. But there is a problem.
entschuldigen(2)	Herr Meier lässt sich entschuldigen, er ist stark erkältet.	Mr. Meier apologizes; he has a severe cold.
die Entschuldigung(1)	Oh, Entschuldigung! – Macht nichts. Kein Problem.	Oh, excuse me! – It’s okay. No problem.
entsorgen(1)	Wie kann ich meine alte Kaffeemaschine entsorgen?	How can I dispose of my old coffee machine?
entspannend(1)	Der Urlaub war sehr entspannend.	The vacation was very relaxing.
entstehen(1)	Hier entsteht ein neues Einkaufszentrum.	A new shopping center is being built here.
entstehen(2)	Andere Kosten entstehen nicht.	No other costs are incurred.
enttäuschen(1)	Leider hat mich sein Verhalten enttäuscht.	Unfortunately, his behavior disappointed me.
enttäuschen(2)	Wir waren von dem Konzert sehr enttäuscht.	We were very disappointed with the concert.
enttäuschen(3)	Das Ergebnis war enttäuschend.	The result was disappointing.
die Enttäuschung(1)	Das Endspiel war eine große Enttäuschung.	The final game was a big disappointment.
entweder ... oder(1)	Nur einer kann gewinnen, entweder du oder ich.	Only one can win, either you or I.
entwickeln(1)	Unser Sohn entwickelt sich gut in der Schule.	Our son is developing well in school.
entwickeln(2)	Die Firma hat ein neues Produkt entwickelt.	The company has developed a new product.
die Entwicklung(1)	Genug Schlaf ist wichtig für die Entwicklung Ihres Kindes.	Enough sleep is important for your child's development.
die Erde(1)	Die Pflanzen brauchen neue Erde.	The plants need new soil.
die Erde(2)	Mein Sohn hat das Glas auf die Erde fallen lassen.	My son dropped the glass on the floor.
die Erde(3)	An der Konferenz nehmen Vertreter aus fast allen Ländern der Erde teil.	Representatives from almost all countries of the world are participating in the conference.
der Erdapfel(1)	Kann ich bitte noch Erdäpfel bekommen?	Can I please get some more potatoes?
das Erdgeschoss(1)	Unsere Wohnung befindet sich im Erdgeschoss.	Our apartment is on the ground floor.
das Ereignis(1)	Alle Zeitungen haben über diese Ereignisse berichtet.	All newspapers reported on these events.
das Ereignis(2)	Das Konzert war ein großes Ereignis.	The concert was a major event.
sich ereignen(1)	Der Unfall ereignete sich am frühen Morgen.	The accident occurred early in the morning.
erfahren(1)	Wann erfahren wir das Ergebnis der Prüfung?	When will we find out the result of the exam?
die Erfahrung(1)	Ich habe zehn Jahre Erfahrung in diesem Beruf.	I have ten years of experience in this profession.
die Erfahrung(2)	Mit diesem Gerät haben wir gute Erfahrungen gemacht.	We have had good experiences with this device.
erfinden(1)	Das Rad wurde vor ca. 6000 Jahren erfunden.	The wheel was invented about 6000 years ago.
die Erfindung(1)	Die Erfindung des Buchdrucks war sehr wichtig für die Menschen.	The invention of the printing press was very important for people.
der Erfolg(1)	Der Film war ein großer Erfolg.	The film was a great success.
der Erfolg(2)	Ich wünsche Ihnen viel Erfolg bei der Prüfung.	I wish you much success in the exam.
erfolgreich(1)	Mein Großvater war ein erfolgreicher Geschäftsmann.	My grandfather was a successful businessman.
erforderlich(1)	Hier ist die Liste der erforderlichen Zutaten für den Kuchen.	Here is the list of required ingredients for the cake.
erforderlich(2)	Es ist erforderlich, dass man den Pass persönlich abholt.	It is necessary to pick up the passport in person.
erfordern(1)	Dieser Job erfordert viel Kraft.	This job requires a lot of strength.
erfüllen(1)	Sie müssen den Vertrag in allen Punkten erfüllen.	You must fulfill the contract in all respects.
erfüllen(2)	Wir erfüllen Ihnen jeden Wunsch.	We will fulfill every wish of yours.
ergänzen(1)	Ergänzen Sie bitte die fehlenden Angaben.	Please fill in the missing information.
das Ergebnis(1)	Ein so gutes Ergebnis hat uns alle überrascht.	Such a good result surprised us all.
erhalten(1)	Ihr Schreiben vom 3. Januar haben wir erhalten.	We have received your letter of January 3rd.
erhöhen(1)	Die Regierung wird sicher bald wieder die Steuern erhöhen.	The government will surely raise taxes again soon.
erhöhen(2)	Die Zahl der Unfälle hat sich stark erhöht.	The number of accidents has increased significantly.
die Erhöhung(1)	Wir streiken für eine Lohnerhöhung.	We are striking for a wage increase.
sich erholen(1)	Im Urlaub habe ich mich sehr gut erholt.	I rested very well on vacation.
sich erholen(2)	Er hat sich nach dem Unfall sehr schnell wieder erholt.	He recovered very quickly after the accident.
die Erholung(1)	Ich habe zu viel gearbeitet. Jetzt brauche ich etwas Erholung.	I have worked too much. Now I need some rest.
erinnern(1)	Bitte, erinnern Sie mich noch einmal an den Termin.	Please remind me again about the appointment.
erinnern(2)	Ich erinnere mich noch genau an Francescos Vater.	I still remember Francesco’s father very clearly.
die Erinnerung(1)	An diese Zeit habe ich viele schöne Erinnerungen.	I have many fond memories of that time.
sich erkälten(1)	Der Junge hat sich beim Baden erkältet.	The boy caught a cold while swimming.
sich erkälten(2)	Ich bin stark erkältet.	I have a severe cold.
die Erkältung(1)	Du hast eine schlimme Erkältung!	You have a bad cold!
erkennen(1)	Ich habe Roberto gleich an seiner Stimme erkannt.	I recognized Roberto immediately by his voice.
erkennen(2)	Auf dem Foto kann man kaum etwas erkennen.	You can hardly recognize anything in the photo.
erkennen(3)	Ich habe erkannt, dass es ein Fehler war, den Kurs nicht fertigzumachen.	I realized that it was a mistake not to finish the course.
erklären(1)	Kannst du mir erklären, wie man diesen Apparat bedient?	Can you explain to me how to operate this device?
erklären(2)	Ich kann mir nicht erklären, wie der Brief verschwinden konnte.	I cannot explain how the letter could have disappeared.
die Erklärung(1)	Hast du schon die Steuererklärung gemacht?	Have you already done the tax return?
die Erklärung(2)	Die Erklärung der Lehrerin ist besser als die Erklärung im Buch.	The teacher’s explanation is better than the explanation in the book.
sich erkundigen(1)	Hast du dich schon nach einem Zug erkundigt?	Have you inquired about a train yet?
sich erkundigen(2)	Ich möchte mich erkundigen, wie es Ihnen geht.	I would like to inquire how you are doing.
erlauben(1)	Ich erlaube meinen Kindern nicht, so lange fernzusehen.	I do not allow my children to watch TV for so long.
erlauben(2)	Parken ist hier nicht erlaubt.	Parking is not allowed here.
die Erlaubnis(1)	Sie hätten ihn vorher um Erlaubnis bitten müssen.	You should have asked him for permission beforehand.
erleben(1)	In unserem Urlaub haben wir viel Schönes erlebt.	We experienced a lot of wonderful things on our vacation.
das Erlebnis(1)	Die Reise war ein tolles Erlebnis.	The trip was a great experience.
erledigen(1)	Diese zwei Pakete müssen zur Post. Könntest du das für mich erledigen?	These two packages need to be taken to the post office. Could you handle that for me?
erleichtern(1)	Ich bin erleichtert, dass alles so gut geklappt hat.	I am relieved that everything worked out so well.
erleichtern(2)	Das Internet erleichtert mir die Arbeit sehr.	The internet makes my work much easier.
die Ermäßigung(1)	Es gibt eine Ermäßigung für Kinder und Senioren.	There is a discount for children and seniors.
ernähren(1)	Wie ernähre ich mich richtig?	How do I eat properly?
ernähren(2)	Meine Eltern müssen beide arbeiten, um die Familie zu ernähren.	My parents both have to work to support the family.
die Ernährung(1)	Ich finde eine gesunde Ernährung wichtig.	I find a healthy diet important.
es(3)	Es wurden bei der Diskussion viele Fragen gestellt.	Many questions were asked during the discussion.
es(4)	Wer ist da? – Ich bin’s.	Who’s there? – It’s me.
es(5)	Mir geht es gut.	I’m doing well.
es(6)	Ich finde es sehr nett von Ihnen, dass Sie mich abholen.	I think it's very kind of you to pick me up.
es(7)	Es macht Spaß, zusammen ein Picknick zu machen.	It’s fun to have a picnic together.
essen(1)	Haben Sie schon zu Mittag gegessen?	Have you had lunch yet?
essen(2)	Ich esse gern Bananen.	I like to eat bananas.
essen(3)	Was gibt es heute zu essen?	What is there to eat today?
das Essen(1)	Darf ich Sie zum Essen einladen?	May I invite you to a meal?
das Essen(2)	Das Essen ist kalt geworden.	The food has gone cold.
der Essig(1)	Am Salat fehlt noch etwas Essig.	The salad needs a bit more vinegar.
die Etage(1)	Das Büro ist in der 3. Etage, Zimmer 305.	The office is on the 3rd floor, Room 305.
etwa(1)	Von hier sind es etwa zwanzig Kilometer.	It’s about twenty kilometers from here.
etwa(2)	Von zu Hause brauche ich etwa 10 Minuten bis zur Arbeit.	It takes about 10 minutes from home to work.
etwa(3)	Du bist doch nicht etwa krank?	You’re not sick, are you?
etwas(1)	Ich muss dir etwas erzählen.	I have to tell you something.
etwas(2)	Ich habe nur Tee. Etwas anderes kann ich Ihnen leider nicht anbieten.	I only have tea. Unfortunately, I can’t offer you anything else.
etwas(3)	Haben Sie etwas zum Schreiben?	Do you have something to write with?
etwas(4)	Wollen wir mit dem Nachtisch noch etwas warten?	Shall we wait a little longer with the dessert?
etwas(5)	So etwas habe ich noch nie gehört.	I have never heard anything like that before.
etwas(6)	Ich habe etwas Gutes für dich gekocht.	I have cooked something good for you.
eventuell(1)	Ich komme eventuell etwas später.	I might come a bit later.
ewig(1)	Ich warte schon ewig auf mein neues Auto!	I’ve been waiting forever for my new car!
der Experte(1)	Ich verstehe ein bisschen was von Computern. Aber ich bin kein Experte.	I know a little about computers, but I am not an expert.
der Export(1)	Hier ist die Firma Schulz, Import und Export.	This is Schulz Company, Import and Export.
der Export(2)	Sonja arbeitet in der Exportabteilung.	Sonja works in the export department.
extra(1)	Die Getränke kosten extra.	The drinks cost extra.
extra(2)	Warum sind Sie nicht gekommen? Ich habe extra auf Sie gewartet.	Why didn’t you come? I waited specifically for you.
extrem(1)	Die Prüfung war extrem schwer.	The exam was extremely difficult.

