german word	german sentence	english translation
das Kabel(1)	Wo ist das Kabel für das Aufnahmegerät?	Where is the cable for the recording device?
das Kabel(2)	Mit Kabel bekommen Sie über 30 Fernsehkanäle.	With a cable, you get over 30 TV channels.
die Kabine(1)	Um zu wählen, gehen Sie bitte in diese Kabine.	To make a call, please go to this booth.
der Kaffee(1)	Bring bitte noch eine Packung Kaffee mit.	Please bring another pack of coffee.
der Kaffee(2)	Zum Frühstück trinke ich gerne Kaffee.	I like to drink coffee for breakfast.
der Kaffee(3)	Wir sind bei Müllers zum Kaffee eingeladen.	We are invited to the Müllers’ for coffee.
der Kaffee(4)	Einen Kaffee, bitte.	A coffee, please.
das Kaffeehaus(1)	Hier in der Nähe ist ein Kaffeehaus.	There is a coffee house nearby.
der Kakao(1)	Zum Frühstück trinke ich immer einen Kakao.	I always drink cocoa for breakfast.
der Kalender(1)	Ich habe den Termin in meinem Kalender notiert.	I noted the appointment in my calendar.
der Kalender(2)	Haben Sie am Montag Zeit? – Moment. Ich muss erst in meinem Terminkalender nachschauen.	Do you have time on Monday? – Hold on. I need to check my calendar first.
kalt(1)	Es ist kalt heute.	It’s cold today.
kalt(2)	Du hast ja ganz kalte Hände.	Your hands are really cold.
kalt(3)	Das Mittagessen ist kalt geworden.	The lunch has gone cold.
kalt(4)	Abends essen wir immer kalt.	In the evening, we always eat cold food.
kalt(5)	Wir hatten einen kalten Winter.	We had a cold winter.
kalt(6)	Mir ist kalt. Mach bitte die Heizung an.	I’m cold. Please turn on the heating.
kalt(7)	Bei dieser Kälte fahre ich nicht mit dem Fahrrad.	In this cold, I’m not riding a bike.
die Kälte(1)	Bei dieser Kälte fahre ich nicht mit dem Fahrrad.	In this cold, I’m not riding a bike.
die Kamera, -s(1)	Ich habe eine ganz neue Kamera.	I have a brand new camera.
kämpfen, kämpft, kämpfte, hat gekämpft(1)	Die Frauen kämpfen für mehr Rechte.	The women are fighting for more rights.
der Kampf, ¨-e(1)	Im Schulbus gibt es immer einen Kampf um die Sitzplätze.	There’s always a fight for seats on the school bus.
der Kanal, ¨-e(1)	Mit Kabel bekommen Sie über 30 Fernsehkanäle.	With a cable, you get over 30 TV channels.
der Kandidat, -en(1)	Wie viele Kandidaten kommen zur Prüfung?	How many candidates are coming for the exam?
die Kanne, -n(1)	Das ist aber eine schöne Teekanne. – Ja, die ist aus China.	That’s a nice teapot. – Yes, it’s from China.
die Kanne(2)	Bitte einen Kaffee! – Eine Tasse oder ein Kännchen?	A coffee, please! – A cup or a pot?
die Kantine, -n(1)	In unserer Kantine kann man günstig essen.	You can eat cheaply in our cafeteria.
das Kapitel, -(1)	Die Lehrerin hat gesagt, wir sollen zwei Kapitel im Buch wiederholen.	The teacher said we should review two chapters in the book.
kaputt(1)	Unsere Waschmaschine ist kaputt.	Our washing machine is broken.
kaputt(2)	Ich bin noch ganz kaputt von der Reise.	I’m still completely exhausted from the trip.
kaputtgehen(1)	Pass bitte mit diesem Glas auf. Es geht leicht kaputt.	Please be careful with this glass. It can break easily.
kaputtgehen(2)	Der Fernseher ist gestern kaputtgegangen.	The TV broke yesterday.
der Käufer, -(1)	Ich habe schon einen Käufer für den alten Tisch.	I already have a buyer for the old table.
die Käuferin, -nen(1)	Ich habe schon eine Käuferin für den alten Tisch.	I already have a female buyer for the old table.
kaum(1)	Ich kann Sie kaum verstehen. Bitte sprechen Sie lauter.	I can hardly understand you. Please speak louder.
kaum(2)	Es hat letzte Woche kaum geregnet.	It hardly rained last week.
kaum(3)	Die Fahrt hat nicht lange gedauert. Kaum 20 Minuten.	The trip didn’t take long. Only about 20 minutes.
kaputtmachen(1)	Wer hat die Lampe kaputtgemacht?	Who broke the lamp?
der Karneval, -s/-e(1)	Dort hängt mein Kostüm für den Karnevals(um)zug.	My costume for the carnival parade is hanging there.
die Karotte, -n(1)	Hasen fressen gern Karotten.	Rabbits like to eat carrots.
die Karriere, -n(1)	Mein Bruder hat große Pläne. Er will Karriere machen.	My brother has big plans. He wants to build a career.
die Karte, -n(1)	Schreibst du mir eine Karte aus dem Urlaub?	Will you send me a postcard from your vacation?
die Karte(2)	Diese Karte gilt nur für die 2. Klasse.	This ticket is only valid for second class.
die Karte(3)	Hast du schon die Karten für das Konzert abgeholt?	Have you already picked up the tickets for the concert?
die Karte(4)	Haben Sie eine Karte von Norddeutschland?	Do you have a map of Northern Germany?
die Karte(5)	Herr Ober, bitte die Speisekarte.	Waiter, please bring the menu.
die Karte(6)	Spielen Sie Karten?	Do you play cards?
kein-(1)	Ich habe leider heute keine Zeit.	Unfortunately, I have no time today.
kein-(2)	Jetzt habe ich noch keinen Hunger.	I’m not hungry yet.
kein-(3)	Ich habe keine Kinder.	I don’t have any children.
kein-(4)	Was für ein Auto haben Sie? – Ich habe keins.	What kind of car do you have? – I don’t have one.
der Keller, -(1)	Unser Keller ist nicht besonders groß.	Our cellar is not very big.
der Kellner, -(1)	Ich bin Kellnerin von Beruf.	I am a waitress by profession.
die Kellnerin, -nen(1)	Ich bin Kellnerin von Beruf.	I am a waitress by profession.
kennen, kennt, kannte, hat gekannt(1)	Kennen Sie hier in der Nähe ein gemütliches Café?	Do you know a cozy café nearby?
kennen, kennt, kannte, hat gekannt(2)	Kennen Sie diese Frau? – Nein, leider nicht.	Do you know this woman? – No, unfortunately not.
kennen, kennt, kannte, hat gekannt(3)	Kennen Sie Berlin? – Ja, eine tolle Stadt.	Do you know Berlin? – Yes, it’s a great city.
kennenlernen, lernt kennen, lernte kennen, hat kennengelernt(1)	Wo habt ihr euch kennengelernt?	Where did you meet?
kennenlernen, lernt kennen, lernte kennen, hat kennengelernt(2)	Ich möchte gern reisen und andere Länder kennenlernen.	I would like to travel and get to know other countries.
die Chipkarte, -n(1)	Ich habe eine Chipkarte für diesen Automaten.	I have a chip card for this machine.
die Fahrkarte, -n(1)	Fahrkarten können Sie am Schalter kaufen.	You can buy tickets at the counter.
die Kartoffel, -n(1)	Kann ich bitte noch Kartoffeln bekommen?	Can I please have more potatoes?
der Käse(1)	Möchtest du Käse aufs Brot?	Do you want cheese on the bread?
die Kasse, -n(1)	Zahlen Sie bitte an der Kasse.	Please pay at the cash register.
die Kassette, -n(1)	Meine Eltern besitzen noch viele Musikkassetten.	My parents still have many music cassettes.
der Kasten, ¨- (D) → Kiste (A, D)(1)	Ich habe zwei Kästen Bier gekauft.	I bought two cases of beer.
der Kasten, ¨- (A, CH) → D, CH: Schrank(2)	Die Handtücher liegen im Kasten.	The towels are in the cupboard.
der Katalog, -e(1)	Ich habe mir ein Kleid aus dem Katalog bestellt.	I ordered a dress from the catalog.
die Katastrophe, -n(1)	Der Urlaub war eine Katastrophe. Es hat nur geregnet.	The vacation was a disaster. It rained the whole time.
(sich etwas) kaufen, kauft, kaufte, hat gekauft(1)	Im Supermarkt kauft man sehr günstig ein.	You can shop very cheaply at the supermarket.
(sich etwas) kaufen, kauft, kaufte, hat gekauft(2)	Ich habe mir einen Pullover gekauft.	I bought myself a sweater.
die Kenntnisse (Pl.)(1)	In vielen Berufen braucht man heute Sprachkenntnisse.	In many professions today, you need language skills.
die Kenntnisse (Pl.)(2)	Ich möchte meine Deutschkenntnisse verbessern.	I want to improve my German skills.
das Kennzeichen, -(1)	Das Auto hat ein Schweizer Kennzeichen.	The car has a Swiss license plate.
die Kerze, -n(1)	Für den Geburtstagstisch brauchen wir viele Blumen und Kerzen.	We need many flowers and candles for the birthday table.
die Kette, -n(1)	Ich habe zum Geburtstag eine goldene Kette bekommen.	I received a gold necklace for my birthday.
das Kind, -er(1)	Mein Bruder hat zwei Kinder.	My brother has two children.
das Kind, -er(2)	Wir haben ein Kind bekommen.	We had a child.
das Kind, -er(3)	Die Kinder spielen Fußball.	The children are playing soccer.
der Kindergarten, ¨- (1)	Morgens bringe ich meinen Sohn in den Kindergarten.	In the morning, I take my son to kindergarten.
die Kindheit(1)	In meiner Kindheit war ich oft auf dem Land bei meinen Großeltern.	In my childhood, I was often in the countryside with my grandparents.
das Kino, -s(1)	Wollen wir ins Kino gehen?	Do you want to go to the movies?
der Kiosk, -e(1)	Zeitungen bekommst du am Kiosk.	You can get newspapers at the kiosk.
die Kirche, -n(1)	Diese Kirche ist aus dem 12. Jahrhundert.	This church is from the 12th century.
der Kauf(1)	Der neue Esstisch war ein guter Kauf.	The new dining table was a good purchase.
die Kiste, -n (A, D) → D: Kasten(1)	Ich habe zwei Kisten Bier gekauft.	I bought two crates of beer.
das Kissen, -(1)	Ohne Kopfkissen kann ich nicht schlafen.	I can’t sleep without a pillow.
klagen, klagt, klagte, hat geklagt(1)	Sie klagt über Kopfschmerzen.	She is complaining about a headache.
klappen, klappt, klappte, hat geklappt(1)	Wie war die Reise? – Gut. Es hat alles prima geklappt.	How was the trip? – Good. Everything worked out perfectly.
klar(1)	Sie müssen noch mehr Deutsch lernen. – Ja, das ist mir klar.	You need to learn more German. – Yes, I’m aware of that.
klar(2)	Kommst du mit? – Klar!	Are you coming along? – Of course!
klar(3)	Ich komme zu deinem Geburtstag, das ist doch klar.	I’m coming to your birthday, that’s clear.
klar(4)	Leider haben wir bei der Bahn keine klare Auskunft bekommen.	Unfortunately, we didn’t get a clear answer from the train company.
klingeln, klingelt, klingelte, hat geklingelt(1)	Ich glaube, es hat an der Tür geklingelt.	I think someone rang the doorbell.
klingeln, klingelt, klingelte, hat geklingelt(2)	Das Telefon klingelt. Drück bitte auf die Klingel!	The phone is ringing. Please press the bell.
die Klingel, -n(1)	Das Telefon klingelt. Drück bitte auf die Klingel!	The phone is ringing. Please press the bell.
klingen, klingt, klang, hat geklungen(1)	Wollen wir einkaufen gehen und danach zusammen kochen? – Ja, das klingt gut.	Do you want to go shopping and then cook together? – Yes, that sounds good.
die Klinik, -en(1)	Ich muss in die Klinik, um meinen kranken Onkel zu besuchen.	I need to go to the clinic to visit my sick uncle.
klopfen, klopft, klopfte, hat geklopft(1)	Da klopft jemand ans Fenster.	Someone is knocking on the window.
klopfen, klopft, klopfte, hat geklopft(2)	Hat es nicht eben geklopft?	Didn’t someone just knock?
der Kloß, ¨-e (D) → D, A: Knödel(1)	Möchten Sie zum Fleisch Kartoffeln oder Klöße? – Klöße, bitte.	Would you like potatoes or dumplings with the meat? – Dumplings, please.
klug(1)	Ich halte sie für klug.	I consider her smart.
klug(2)	Er hat sich in der Diskussion nicht besonders klug verhalten.	He didn’t behave very smartly in the discussion.
klug(3)	Das ist ein kluger Hund.	That is a smart dog.
klären, klärt, klärte, hat geklärt(1)	Ich hoffe, wir können dieses Problem bald klären.	I hope we can resolve this problem soon.
klasse(1)	Ich finde unseren Lehrer klasse.	I think our teacher is great.
die Klasse, -n(1)	In der Klasse sind 24 Schülerinnen und Schüler.	There are 24 students in the class.
die Klasse(2)	Im Herbst komme ich in die 7. Klasse.	In the fall, I will enter the 7th grade.
die Klasse(3)	Einmal nach Frankfurt, 1. Klasse, bitte.	A one-way ticket to Frankfurt, first class, please.
die Klassenarbeit, -en (D)(1)	Mein Sohn schreibt bei Klassenarbeiten immer gute Noten.	My son always gets good grades on tests.
knapp(1)	Mach schnell. Die Zeit ist knapp.	Hurry up. Time is tight.
knapp(2)	Unser Geld wird knapp. Wir müssen sparen.	Our money is running out. We need to save.
knapp(3)	Die Fahrt war kurz. Nur knapp eine Stunde.	The trip was short. Just under an hour.
knapp(4)	Die Wohnung hat nur knapp 30 m².	The apartment is only just under 30 m².
knapp(5)	Der Tisch hat nur knapp 50 Euro gekostet.	The table cost just under 50 euros.
das Klavier, -e(1)	Meine Tochter möchte Klavier spielen lernen.	My daughter wants to learn to play the piano.
kleben, klebt, klebte, hat geklebt(1)	Die Briefmarke klebt nicht mehr.	The postage stamp doesn’t stick anymore.
kleben, klebt, klebte, hat geklebt(2)	Ich klebe Ihnen ein Pflaster darauf.	I’m putting a bandage on it for you.
das Kleid, -er(1)	Ich habe mir ein neues Kleid gekauft.	I bought a new dress.
die Kleidung(1)	Hier brauchen Sie auch im Sommer warme Kleidung.	Here, you need warm clothing even in summer.
klein(1)	Unsere Wohnung ist klein.	Our apartment is small.
klein(2)	Unser Kind ist noch klein.	Our child is still small.
klein(3)	Wir machen am Sonntag einen kleinen Ausflug.	We’re going on a small trip on Sunday.
die Kneipe, -n (D)(1)	Gehen wir noch in eine Kneipe ein Bier trinken?	Shall we go to a pub to have a beer?
das Knie, - (1)	Ich habe mich am Knie verletzt. Jetzt kann ich nicht laufen.	I injured my knee. Now I can’t walk.
der Knochen, - (1)	Ich bin hingefallen. Jetzt tun mir alle Knochen weh.	I fell down. Now all my bones hurt.
der Knödel, - (D, A) → D: Kloß(1)	Möchten Sie zum Fleisch Erdäpfel oder Knödel? – Knödel bitte.	Would you like potatoes or dumplings with the meat? – Dumplings, please.
der Knopf, ¨-e(1)	An meiner Jacke fehlt ein Knopf.	My jacket is missing a button.
der Knopf, ¨-e(2)	Der Fahrstuhl kommt nicht. – Sie müssen auf den Knopf drücken.	The elevator isn’t coming. – You need to press the button.
klettern, klettert, kletterte, ist geklettert(1)	Die Kinder sind auf den Baum geklettert.	The children climbed the tree.
klicken, klickt, klickte, hat geklickt(1)	Wenn du die Datei öffnen willst, musst du mit der Maus zweimal klicken.	If you want to open the file, you need to double-click with the mouse.
klicken, klickt, klickte, hat geklickt(2)	Um das Wort zu markieren, genügt ein Doppelklick mit der linken Maustaste.	To highlight the word, a double-click with the left mouse button is sufficient.
der Klick, -s(1)	Um das Wort zu markieren, genügt ein Doppelklick mit der linken Maustaste.	To highlight the word, a double-click with the left mouse button is sufficient.
das Klima(1)	Alle sagen, dass sich das Klima ändert.	Everyone says that the climate is changing.
die Klimaanlage, -n(1)	Im Sommer brauchen wir eine Klimaanlage.	We need an air conditioner in the summer.
kochen, kocht, kochte, hat gekocht(1)	Ich koche gern.	I like to cook.
kochen, kocht, kochte, hat gekocht(2)	Das Wasser kocht.	The water is boiling.
kochen, kocht, kochte, hat gekocht(3)	Der Reis muss etwa 20 Minuten kochen.	The rice needs to cook for about 20 minutes.
der Koch, ¨-e(1)	Ein Freund von mir ist Koch in einem teuren Restaurant.	A friend of mine is a chef in an expensive restaurant.
die Köchin, -nen(1)	Eine Freundin von mir ist Köchin in einem teuren Restaurant.	A friend of mine is a female chef in an expensive restaurant.
der Koffer, - (1)	Ich habe den Koffer schon gepackt.	I have already packed the suitcase.
der Kollege, -n(1)	Ich habe guten Kontakt zu meinen Kollegen.	I have good contact with my colleagues.
der Kollege, -n(2)	Mein neuer Kollege ist sehr nett.	My new colleague is very nice.
die Kollegin, -nen(1)	Mein neuer Kollege ist sehr nett.	My new colleague is very nice.
komisch(1)	Das Essen schmeckt komisch. Probier mal.	The food tastes weird. Try it.
komisch(2)	Der Film war sehr komisch. Wir haben viel gelacht.	The movie was very funny. We laughed a lot.
komisch(3)	Eine grüne Hose und gelbe Schuhe? Das sieht komisch aus.	Green pants and yellow shoes? That looks weird.
kommen, kommt, kam, ist gekommen(1)	Woher kommen Sie? – Aus Frankreich.	Where are you from? – From France.
kommen, kommt, kam, ist gekommen(2)	Wir gehen heute Abend ins Konzert. Kommen Sie auch?	We’re going to the concert this evening. Are you coming too?
kommen, kommt, kam, ist gekommen(3)	Kommen Sie doch mal wieder zu uns.	Do come and visit us again.
kommen, kommt, kam, ist gekommen(4)	Wenn Sie mal nach Köln kommen, besuchen Sie uns.	If you come to Cologne, visit us.
kommen, kommt, kam, ist gekommen(5)	Steffi kommt im Herbst in die Schule.	Steffi will start school in the fall.
kommen, kommt, kam, ist gekommen(6)	Die Straßenbahn muss gleich kommen.	The tram should be arriving soon.
kommen, kommt, kam, ist gekommen(7)	Wer kommt als Nächster dran?	Who is next?
kommen, kommt, kam, ist gekommen(8)	Die Handtücher kommen in den Schrank.	The towels go in the cupboard.
kommen, kommt, kam, ist gekommen(9)	Wie sind Sie denn auf diese Idee gekommen?	How did you come up with this idea?
die Kommunikation(1)	Die Kommunikation zwischen den Abteilungen ist gut.	The communication between departments is good.
komplett(1)	Ich habe den Termin komplett vergessen.	I completely forgot the appointment.
komplett(2)	Die Wohnung ist jetzt komplett eingerichtet.	The apartment is now fully furnished.
kompliziert(1)	Er schreibt viel zu kompliziert.	He writes way too complicatedly.
der Kompromiss, -e(1)	Alle wollen etwas anderes. Wir müssen einen Kompromiss finden.	Everyone wants something different. We need to find a compromise.
die Konferenz, -en(1)	Die Konferenz findet in Raum 19 statt.	The conference is taking place in Room 19.
die Konfitüre, -n (CH)(1)	Bring bitte noch ein Glas Konfitüre mit.	Please bring another jar of jam.
der Konflikt, -e(1)	Das ist ein alter Konflikt.	That’s an old conflict.
der Konflikt, -e(2)	Ich habe einen Konflikt mit meinen Eltern.	I have a conflict with my parents.
der König, -e(1)	Der spanische König ist in Deutschland zu Besuch.	The Spanish king is visiting Germany.
die Konkurrenz(1)	Die Reparatur ist mir hier zu teuer. Bei der Konkurrenz bekomme ich sie für die Hälfte.	The repair is too expensive here. With the competition, I can get it for half the price.
die Konkurrenz(2)	Es ist schwer, ein Geschäft aufzumachen. Die Konkurrenz ist groß.	It’s hard to start a business. The competition is fierce.
das Konsulat, -e(1)	Ein Visum bekommst du auch im Konsulat.	You can also get a visa at the consulate.
konsumieren, konsumiert, konsumierte, hat konsumiert(1)	Die Europäer haben im letzten Jahr mehr Fleisch konsumiert.	Europeans consumed more meat last year.
konsumieren, konsumiert, konsumierte, hat konsumiert(2)	Der Konsum von Lebensmitteln steigt.	The consumption of food is rising.
der Kontakt, -e(1)	Ich habe wenig Kontakt zu meinen Kollegen.	I have little contact with my colleagues.
das Konto, Konten(1)	Ich möchte ein Konto eröffnen.	I want to open an account.
das Konto, Konten(2)	Das Geld überweisen wir am 1. März auf Ihr Konto.	We’ll transfer the money to your account on March 1st.
das Girokonto, -en(1)	Mein Girokonto kostet gar nichts.	My checking account is free of charge.
kontrollieren, kontrolliert, kontrollierte, hat kontrolliert(1)	Beim Auto müssen Sie regelmäßig das Öl kontrollieren.	You need to regularly check the oil in the car.
kontrollieren, kontrolliert, kontrollierte, hat kontrolliert(2)	Können Sie bitte meinen Brief korrigieren?	Could you please correct my letter?
die Kontrolle, -n(1)	An den Grenzen gibt es kaum noch Kontrollen.	There are hardly any checks at the borders.
die Kontrolle, -n(2)	Fahrkartenkontrolle! Bitte Ihre Fahrkarten!	Ticket inspection! Please show your tickets!
sich konzentrieren, konzentriert sich, konzentrierte sich, hat sich konzentriert(1)	Bitte stör mich jetzt nicht. Ich muss mich auf meine Arbeit konzentrieren.	Please don’t disturb me now. I need to concentrate on my work.
das Konzert, -e(1)	Für das Konzert am Sonntag gibt es noch Karten.	There are still tickets available for the concert on Sunday.
der Kopf, ¨-e(1)	Ich habe Kopfschmerzen.	I have a headache.
der Kopf, ¨-e(2)	Michael kann gut im Kopf rechnen.	Michael can do mental arithmetic well.
kopieren(1)	Kann ich mir diesen Artikel kopieren?	Can I copy this article?
kopieren(2)	Ich kopiere dir die Datei auf die Speicherkarte.	I’ll copy the file onto the memory card.
kopieren(3)	Ich kann dir die CD kopieren.	I can copy the CD for you.
die Kopie, -n(1)	Machst du mir bitte eine Kopie?	Can you make a copy for me?
der Kopierer, - (1)	Der Kopierer ist schon wieder kaputt.	The copier is broken again.
der Körper, - (1)	Der Arzt sagt, ich muss etwas für meinen Körper tun, z. B. schwimmen oder Fahrrad fahren.	The doctor says I need to do something for my body, like swimming or biking.
der Körper, - (2)	Körperliche Arbeit macht mir nichts aus.	Physical work doesn’t bother me.
korrekt(1)	Ich habe die Rechnung geprüft. Alles ist korrekt.	I checked the invoice. Everything is correct.
der Korridor, -e (D, CH) → Gang; D: Flur(1)	Wir warten draußen im Korridor.	We’re waiting outside in the corridor.
korrigieren, korrigiert, korrigierte, hat korrigiert(1)	Können Sie bitte meinen Brief korrigieren?	Could you please correct my letter?
korrigieren, korrigiert, korrigierte, hat korrigiert(2)	Der Lehrer hat meine Fehler korrigiert.	The teacher corrected my mistakes.
kosten, kostet, kostete, hat gekostet(1)	Wie viel kostet das T-Shirt? – 15 Euro.	How much does the T-shirt cost? – 15 euros.
kosten, kostet, kostete, hat gekostet(2)	Eine Wohnung zu finden, kostet viel Zeit.	Finding an apartment costs a lot of time.
die Kosten (Pl.)(1)	Die Kosten für die Reise bekomme ich von der Firma.	I will get the travel costs reimbursed by the company.
kostenlos(1)	Diese Zeitschrift kostet nichts. Sie ist kostenlos.	This magazine is free. It costs nothing.
das Kostüm, -e(1)	In dem Film tragen die Leute bunte Kostüme.	In the movie, people wear colorful costumes.
die Kraft, ¨-e(1)	Für diese Arbeit braucht man viel Kraft.	This job requires a lot of strength.
kräftig(1)	Der Mann ist kräftig. Er macht viel Sport und isst viel.	The man is strong. He does a lot of sports and eats a lot.
kräftig(2)	Die Suppe musst du kräftig würzen.	You need to season the soup well.
das Kraftfahrzeug, -e(1)	Auf dieser Straße sind Kraftfahrzeuge nicht erlaubt.	Motor vehicles are not allowed on this road.
das Kraftwerk, -e(1)	Die Menschen protestieren gegen das Kraftwerk.	People are protesting against the power plant.
krank(1)	Ich war zwei Wochen krank.	I was sick for two weeks.
krank(2)	Ich muss mich um meine kranke Großmutter kümmern.	I need to take care of my sick grandmother.
der Kranke, -n(1)	Kranke brauchen viel Ruhe.	Sick people need a lot of rest.
die Kranke, -n(1)	Ich habe eine Kranke in der Familie.	I have a sick person in the family.
das Krankenhaus, ¨-er(1)	Er hat sich verletzt und musste ins Krankenhaus.	He got injured and had to go to the hospital.
die Krankenkasse, -n(1)	Die Krankenkasse bezahlt die Medikamente.	The health insurance covers the medication.
der Krankenpfleger, - (1)	Mein Bruder arbeitet als Krankenpfleger im Krankenhaus.	My brother works as a nurse in the hospital.
die Krankenschwester, -n(1)	Meine Cousine möchte gern Krankenschwester werden.	My cousin would like to become a nurse.
der Krankenwagen, - (1)	Wir mussten einen Krankenwagen rufen.	We had to call an ambulance.
die Krankheit, -en(1)	Gegen welche Krankheiten sollte ich mich impfen lassen?	Which diseases should I get vaccinated against?
die Krankheit, -en(2)	Was für eine Krankheit hat Herr Brandner?	What kind of illness does Mr. Brandner have?
kreativ(1)	Die Kinder sind beim Basteln sehr kreativ.	The children are very creative when crafting.
kreativ(2)	Wir brauchen eine kreative Lösung für dieses Problem.	We need a creative solution to this problem.
der Kredit, -e(1)	Ich habe den Wagen auf Kredit gekauft.	I bought the car on credit.
der Kredit, -e(2)	Wir haben von der Bank einen Kredit bekommen.	We received a loan from the bank.
die Kreditkarte, -n(1)	Kann ich mit Kreditkarte zahlen?	Can I pay by credit card?
der Kreis, -e(1)	Die Kinder sitzen im Kindergarten im Kreis.	The children are sitting in a circle in the kindergarten.
der Kreis, -e(2)	Bitte malt jetzt alle einen Kreis in euer Heft.	Please draw a circle in your notebook now.
der Kreis, -e(3)	Unser Ort gehört zum Kreis Neuss.	Our town belongs to the Neuss district.
das Kreuz, -e(1)	Was bedeutet dieses Kreuz hier?	What does this cross mean here?
die Kreuzung, -en(1)	Fahren Sie an der nächsten Kreuzung rechts.	Turn right at the next intersection.
der Krieg, -e(1)	Es herrscht noch immer Krieg in diesem Land.	There is still war in this country.
der Krieg, -e(2)	Der Lehrer spricht über den Zweiten Weltkrieg.	The teacher talks about World War II.
kriegen, kriegt, kriegte, hat gekriegt(1)	Haben Sie meinen Brief gekriegt?	Did you receive my letter?
kriegen, kriegt, kriegte, hat gekriegt(2)	Was kriegen Sie? – Ein Schwarzbrot, bitte.	What would you like? – A rye bread, please.
Kriminal- die Kriminalpolizei(1)	Ein Nachbar von uns arbeitet bei der Kriminalpolizei.	A neighbor of ours works in the criminal police.
der Krimi, -s(1)	Heute Abend kommt ein spannender Krimi im Fernsehen.	An exciting crime drama is on TV tonight.
die Krise, -n(1)	Die Wirtschaft steckt in einer schweren Krise.	The economy is in a severe crisis.
kritisieren, kritisiert, kritisierte, hat kritisiert(1)	Kritisiere mich nicht so oft.	Don’t criticize me so often.
kritisieren, kritisiert, kritisierte, hat kritisiert(2)	Der Lehrer hat meine Fehler kritisiert.	The teacher criticized my mistakes.
die Kritik, -en(1)	Es gibt viel Kritik an der Politik der Regierung.	There is a lot of criticism of the government’s policy.
die Kritik, -en(2)	Dieser Film hat sehr gute Kritiken bekommen.	This film has received very good reviews.
kritisch(1)	Es gab eine Diskussion über die Lebensmittelpreise. Ein Journalist hat kritische Fragen gestellt.	There was a discussion about food prices. A journalist asked critical questions.
die Küche, -n(1)	Ich suche eine Wohnung mit drei Zimmern, Küche und Bad.	I’m looking for an apartment with three rooms, a kitchen, and a bathroom.
die Küche, -n(2)	Ich mag die deutsche Küche.	I like German cuisine.
der Kuchen, - (1)	Ich habe einen Kuchen gebacken.	I baked a cake.
der Kugelschreiber, - (1)	Mein Kugelschreiber ist weg.	My ballpoint pen is missing.
der Kuli, -s(1)	Hast du einen Kuli für mich?	Do you have a pen for me?
kühl(1)	Es ist kühl draußen. Zieh dir eine Jacke an.	It’s cool outside. Put on a jacket.
der Kühlschrank, ¨-e(1)	Stell die Milch in den Kühlschrank!	Put the milk in the fridge!
die Kultur, -en(1)	Ich interessiere mich für andere Länder und Kulturen.	I’m interested in other countries and cultures.
kulturell(1)	Es gibt große kulturelle Unterschiede zwischen den Ländern.	There are large cultural differences between countries.
küssen, küsst, küsste, hat geküsst(1)	Er nahm sie in die Arme und küsste sie.	He took her in his arms and kissed her.
küssen, küsst, küsste, hat geküsst(2)	Beim Verabschieden haben wir uns alle geküsst.	We all kissed each other when saying goodbye.
sich kümmern, kümmert sich, kümmerte sich, hat sich gekümmert(1)	Ich kann nicht arbeiten. Ich muss mich um die Kinder kümmern.	I can’t work. I need to take care of the children.
sich kümmern, kümmert sich, kümmerte sich, hat sich gekümmert(2)	Ich habe keine Zeit. Ich muss mich um das Essen kümmern.	I have no time. I need to take care of the food.
der Kunde, -n(1)	Sie ist schon lange bei mir Kundin. Ich habe ihr einen Sonderpreis gegeben.	She has been a customer for a long time. I gave her a special price.
der Kunde, -n(2)	Einen Augenblick, bitte. Ich habe einen Kunden.	One moment, please. I have a customer.
die Kundin, -nen(1)	Sie ist schon lange bei mir Kundin. Ich habe ihr einen Sonderpreis gegeben.	She has been a customer for a long time. I gave her a special price.
kündigen, kündigt, kündigte, hat gekündigt(1)	Ich war mit meiner Stelle nicht zufrieden und habe gekündigt.	I was not satisfied with my position and quit.
kündigen, kündigt, kündigte, hat gekündigt(2)	Hast du deine Wohnung schon gekündigt?	Have you already terminated your apartment?
kündigen, kündigt, kündigte, hat gekündigt(3)	Ich möchte die Zeitschrift nicht mehr. – Dann musst du schriftlich kündigen.	I no longer want the magazine. – Then you have to cancel it in writing.
die Kündigung, -en(1)	Ich habe die Kündigung bekommen. Jetzt bin ich arbeitslos.	I received the termination notice. Now I’m unemployed.
die Kunst, ¨-e(1)	Ich verstehe nichts von moderner Kunst.	I don’t understand anything about modern art.
der Kuss, ¨-e(1)	Gib der Mama einen Kuss!	Give mom a kiss!
die Küste, -n(1)	Unser Dorf liegt direkt an der Küste.	Our village is right on the coast.
das Kuvert, -s (A) → der Briefumschlag; CH: Couvert(1)	Ich hätte gern 50 Kuverts und Briefmarken dazu.	I would like 50 envelopes and stamps with it.
der Künstler, - (1)	In diesem Stadtteil wohnen viele Künstlerinnen.	Many artists live in this district.
die Künstlerin, -nen(1)	Neben uns wohnt eine Musikerin.	A musician lives next door to us.
künstlich(1)	Ich mag kein künstliches Licht.	I don’t like artificial light.
der Kunststoff, -e(1)	Der Stuhl ist aus Kunststoff.	The chair is made of plastic.
der Kurs, -e(1)	Ich besuche regelmäßig einen Deutschkurs.	I regularly attend a German course.
der Kursleiter, - (1)	Die Kursleiterin ist mit unserer Kursgruppe manchmal in den Computerraum gegangen.	The course instructor sometimes took our group to the computer lab.
die Kursleiterin, -nen(1)	Die Kursleiterin ist mit unserer Kursgruppe manchmal in den Computerraum gegangen.	The course instructor sometimes took our group to the computer lab.
die Kurve, -n(1)	Fahr bitte nicht so schnell in die Kurven.	Please don’t drive so fast around the curves.
die Kurve, -n(2)	Achtung. Das Stauende ist gleich hinter einer Kurve.	Attention. The end of the traffic jam is just behind a curve.
kurz(1)	Ricardo hat kurze Haare.	Ricardo has short hair.
kurz(2)	Kann ich Sie kurz sprechen?	Can I speak to you briefly?
kurz(3)	Kurz vor 8 Uhr hat das Telefon geklingelt.	Just before 8 o'clock, the phone rang.
kurz(4)	Mein Mann ist kurz nach mir gekommen.	My husband arrived shortly after me.
kurz(5)	Ich bin vor Kurzem nach München gezogen.	I moved to Munich recently.
kurz(6)	Ich wohne seit Kurzem in München.	I have been living in Munich for a short time.
kurz(7)	Ich habe das Kleid kürzer machen lassen.	I had the dress shortened.
kürzlich(1)	Wir haben doch kürzlich darüber gesprochen, dass wir am Wochenende wegfahren wollen.	We talked recently about wanting to go away for the weekend.

