der Saal, Säle(1)	Für unsere Familienfeier haben wir einen kleinen Saal gemietet.	For our family celebration, we rented a small hall.
die Sache, -n(1)	Wir haben unsere Sachen im Hotel gelassen.	We left our things at the hotel.
die Sache, -n(2)	Er hat zum Geburtstag viele Sachen bekommen.	He received many things for his birthday.
die Sache, -n(3)	Das geht mich nichts an. Das ist Ihre Sache.	That’s none of my business. It’s your concern.
der Sack, ¨-e(1)	Ich hätte gern einen Sack Kartoffeln.	I would like a sack of potatoes.
der Sack, ¨-e(2)	Wo soll ich die Säcke mit dem Müll hinstellen?	Where should I put the sacks with the trash?
der Saft, ¨-e(1)	Ich trinke gern Apfelsaft.	I like to drink apple juice.
sagen, sagt, sagte, hat gesagt(1)	Entschuldigung! Was haben Sie gesagt?	Excuse me! What did you say?
sagen, sagt, sagte, hat gesagt(2)	Können Sie mir bitte sagen, wo hier ein Geldautomat ist?	Can you please tell me where there is an ATM?
sagen, sagt, sagte, hat gesagt(3)	Wie sagt man „sorry“ auf Deutsch?	How do you say “sorry” in German?
sagen, sagt, sagte, hat gesagt(4)	Sag mal, wie geht’s dir denn?	Tell me, how are you?
die (Schlag-)Sahne (D) → A: (Schlag-)Obers; CH: (Schlag-)Rahm(1)	Ich hätte gern ein Stück Torte mit Sahne.	I would like a piece of cake with cream.
die Saison, -s(1)	Urlaub in den Schulferien ist immer teurer. Das ist die Saison mit den höchsten Preisen.	Vacation during school holidays is always more expensive. This is the season with the highest prices.
der Salat, -e(1)	Möchten Sie zum Fisch einen Salat?	Would you like a salad with the fish?
die Salbe, -n(1)	Diese Salbe gibt es nur auf Rezept.	This ointment is only available with a prescription.
der Salon, -s(1)	Sie arbeitet als Friseurin in einem Salon.	She works as a hairdresser in a salon.
das Salz, -e(1)	Gib mir bitte mal das Salz!	Please pass me the salt!
salzig(1)	Dieses Essen ist zu salzig für mich.	This food is too salty for me.
sammeln, sammelt, sammelte, hat gesammelt(1)	Mein Bruder sammelt Briefmarken.	My brother collects stamps.
sammeln, sammelt, sammelte, hat gesammelt(2)	Im Herbst sammeln wir im Wald Pilze.	In autumn, we collect mushrooms in the forest.
sämtliche(1)	Sämtliche Fenster müssen geschlossen bleiben.	All windows must remain closed.
der Sand(1)	Die Kinder spielen gern im Sand.	The children like to play in the sand.
der Sänger, -(1)	Wie findest du diesen Sänger? − Ich finde seine Stimme toll.	How do you find this singer? – I think his voice is great.
die Sängerin, -nen(1)	Die Sängerin hat einen tollen Auftritt gehabt.	The female singer had a great performance.
satt(1)	Möchten Sie noch etwas? – Nein danke, ich bin satt.	Would you like anything else? – No thanks, I’m full.
der Satz, ¨-e(1)	Den letzten Satz verstehe ich nicht.	I don’t understand the last sentence.
sauber(1)	Bringen Sie mir bitte ein sauberes Glas!	Please bring me a clean glass!
sauber(2)	Ich muss noch das Bad sauber machen.	I still need to clean the bathroom.
sauer(1)	Die Äpfel sind mir zu sauer.	The apples are too sour for me.
sauer(2)	Die Milch ist sauer.	The milk is sour.
sauer(3)	Immer kommst du zu spät. Ich bin wirklich sauer auf dich.	You’re always late. I’m really angry with you.
die Schachtel, -n(1)	Ich hätte gern eine Schachtel Zigaretten.	I would like a box of cigarettes.
die Schachtel, -n(2)	Meiner Mutter schenke ich eine Schachtel Pralinen.	I am giving my mother a box of chocolates.
schade(1)	Ich kann leider nicht mitkommen. – Das ist aber schade!	Unfortunately, I can’t come along. – That’s a shame!
schade(2)	Schade, dass du nicht mitkommen kannst.	It’s a pity that you can’t come along.
schaden, schadet, schadete, hat geschadet(1)	Ein kleines Glas Wein kann nicht schaden.	A small glass of wine can’t hurt.
der Schaden, ¨-(1)	Ich hatte einen Unfall mit dem Auto. Jetzt muss ich den Schaden der Versicherung melden.	I had a car accident. Now I have to report the damage to the insurance company.
schädlich(1)	Rauchen ist schädlich für die Gesundheit.	Smoking is harmful to health.
schaffen, schafft, schaffte, hat geschafft(1)	Kannst du mir helfen, die Party vorzubereiten? Ich schaffe das nicht allein.	Can you help me prepare the party? I can’t manage it alone.
schalten, schaltet, schaltete, hat geschaltet(1)	Schalten Sie bitte das Licht aus, wenn Sie gehen.	Please turn off the light when you leave.
schalten, schaltet, schaltete, hat geschaltet(2)	Kannst du bitte den Fernseher einschalten. Jetzt kommen gleich die Nachrichten.	Can you please turn on the TV? The news is about to start.
schalten, schaltet, schaltete, hat geschaltet(3)	Du musst jetzt in den ersten Gang schalten.	You need to shift into first gear now.
der Schalter, -(1)	Der Lichtschalter ist rechts neben der Tür.	The light switch is to the right of the door.
der Schalter, -(2)	Briefmarken bekommen Sie am Schalter 3.	You can get stamps at counter 3.
scharf(1)	Bei uns zu Hause essen wir immer sehr scharf.	We always eat very spicy at home.
scharf(2)	Hast du kein schärferes Messer?	Do you have a sharper knife?
der Schatten, -(1)	Gestern hatten wir 25 Grad im Schatten.	Yesterday we had 25 degrees in the shade.
schätzen, schätzt, schätzte, hat geschätzt(1)	Wie alt ist der Chef? – Ich weiß nicht, ich schätze, um die Fünfzig.	How old is the boss? – I don’t know, I estimate around fifty.
schätzen, schätzt, schätzte, hat geschätzt(2)	Ich schätze deine gute Arbeit.	I appreciate your good work.
schauen, schaut, schaute, hat geschaut(1)	Schau mal! Da vorne ist noch ein Platz frei.	Look! There’s still a free seat up ahead.
schauen, schaut, schaute, hat geschaut(2)	Möchtest du beim Fußballspiel zuschauen?	Would you like to watch the soccer game?
das Schaufenster, -(1)	Ich habe im Schaufenster eine schicke Bluse gesehen.	I saw a stylish blouse in the shop window.
der Schauspieler, -(1)	Der Film war toll. Die Schauspieler waren sehr gut.	The movie was great. The actors were very good.
die Schauspielerin, -nen(1)	Die Schauspielerin hat einen tollen Auftritt gehabt.	The actress had a great performance.
die Scheibe, -n(1)	Fünf Scheiben Käse, bitte.	Five slices of cheese, please.
die Scheibe, -n(2)	Die Scheiben sind ganz schmutzig. Ich muss die Fenster putzen.	The panes are very dirty. I need to clean the windows.
sich scheiden lassen, lässt sich scheiden, ließ sich scheiden, hat sich scheiden lassen(1)	Meine Nachbarn haben sich scheiden lassen.	My neighbors got divorced.
sich scheiden lassen, lässt sich scheiden, ließ sich scheiden, hat sich scheiden lassen(2)	Meine Kollegin ist geschieden.	My colleague is divorced.
die Scheidung, -en(1)	Wann war die Scheidung?	When was the divorce?
der Schein, -e(1)	Kannst du einen Schein in Kleingeld wechseln?	Can you change a bill into small change?
der Schein, -e(2)	Hast du Kleingeld für den Automaten? Ich habe nur Scheine.	Do you have small change for the machine? I only have bills.
scheinen, scheint, schien, hat geschienen(1)	Gestern hat es geregnet. Heute scheint wieder die Sonne.	It rained yesterday. Today the sun is shining again.
scheinen, scheint, schien, hat geschienen(2)	Mein Kollege scheint krank zu sein. Er war heute nicht im Büro.	My colleague seems to be ill. He wasn’t at the office today.
schenken, schenkt, schenkte, hat geschenkt(1)	Wir wollen dir zum Geburtstag etwas schenken.	We want to give you something for your birthday.
die Schere, -n(1)	Die Schere hier schneidet schlecht. Hast du noch eine andere?	The scissors here cut poorly. Do you have another one?
schicken, schickt, schickte, hat geschickt(1)	Ich habe meinen Freunden eine Einladung zur Hochzeit geschickt.	I sent my friends an invitation to the wedding.
schicken, schickt, schickte, hat geschickt(2)	Schick mir doch eine E-Mail.	Please send me an email.
schicken, schickt, schickte, hat geschickt(3)	Ich habe die Kinder einkaufen geschickt. Wir haben keine Milch mehr zu Hause.	I sent the kids shopping. We don’t have any milk at home.
schieben, schiebt, schob, hat geschoben(1)	Leider ist mein Fahrrad kaputtgegangen. Ich musste es nach Hause schieben.	Unfortunately, my bike broke down. I had to push it home.
schieben, schiebt, schob, hat geschoben(2)	Wir können den Schrank links an die Wand schieben; dann haben wir mehr Platz.	We can push the cupboard to the left against the wall; then we will have more space.
schief(1)	Der Spiegel hängt ganz schief.	The mirror is hanging crookedly.
schießen, schießt, schoss, hat geschossen(1)	Unsere Mannschaft hat ein Tor geschossen.	Our team scored a goal.
das Schiff, -e(1)	Sind Sie mit dem Schiff oder mit dem Flugzeug gekommen?	Did you come by ship or by plane?
das Schild, -er(1)	Kannst du lesen, was dort auf dem Schild steht?	Can you read what is written on the sign there?
das Schild, -er(2)	Machen Sie bitte das Schild ab? Der Pullover ist ein Geschenk.	Please remove the sign. The sweater is a gift.
schimpfen, schimpft, schimpfte, hat geschimpft(1)	Der Arzt hat mit mir geschimpft, weil ich zu wenig Sport mache.	The doctor scolded me for not exercising enough.
schimpfen, schimpft, schimpfte, hat geschimpft(2)	Alle schimpfen über/auf das Wetter.	Everyone is complaining about the weather.
der Schinken, -(1)	Bitte, ein Brötchen mit Schinken.	Please, a roll with ham.
der Schirm, -e(1)	Es regnet. Hast du einen Schirm dabei?	It’s raining. Do you have an umbrella?
schlafen, schläft, schlief, hat geschlafen(1)	Haben Sie gut geschlafen?	Did you sleep well?
schlafen, schläft, schlief, hat geschlafen(2)	Wenn Sie mal nach München kommen, können Sie bei uns schlafen.	If you come to Munich, you can stay at our place.
der Schlaf(1)	Das Kind macht jeden Tag nach dem Mittagessen einen kurzen Schlaf.	The child takes a short nap every day after lunch.
der Schlaf(2)	Genügend Schlaf ist wichtig für die Gesundheit.	Enough sleep is important for health.
schlagen, schlägt, schlug, hat geschlagen(1)	Wer hat den Weltmeister geschlagen?	Who defeated the world champion?
schlagen, schlägt, schlug, hat geschlagen(2)	Ich muss einen Nagel in die Wand schlagen. Wo ist der Hammer?	I need to hammer a nail into the wall. Where is the hammer?
schlagen, schlägt, schlug, hat geschlagen(3)	Das Herz schlug mir bis zum Hals.	My heart was pounding in my throat.
schließen, schließt, schloss, hat geschlossen(1)	Bitte, schließen Sie die Tür.	Please close the door.
schließen, schließt, schloss, hat geschlossen(2)	Die Tür schließt automatisch.	The door closes automatically.
schließen, schließt, schloss, hat geschlossen(3)	Die Banken sind am Samstag geschlossen.	The banks are closed on Saturday.
schließen, schließt, schloss, hat geschlossen(4)	Wir schließen um 20.00 Uhr.	We close at 8:00 PM.
schließen, schließt, schloss, hat geschlossen(5)	Wann können wir den Mietvertrag abschließen?	When can we finalize the rental contract?
schließen, schließt, schloss, hat geschlossen(6)	Ich hatte die Papiere in den Schreibtisch eingeschlossen.	I had locked the papers in the desk.
der Schnee(1)	Im Februar gibt es oft viel Schnee.	In February, there is often a lot of snow.
schneien, es schneit, es schneite, es hat geschneit(1)	Heute Nacht hat es geschneit.	It snowed last night.
(sich) schneiden, schneidet, schnitt, hat geschnitten(1)	Das Messer schneidet nicht.	The knife doesn’t cut.
(sich) schneiden, schneidet, schnitt, hat geschnitten(2)	Hast du ein Pflaster? Ich habe mich geschnitten.	Do you have a bandage? I cut myself.
(sich) schneiden, schneidet, schnitt, hat geschnitten(3)	Wann lässt du deine Haare schneiden?	When are you getting your hair cut?
schnell(1)	Warum fährst du so schnell?	Why are you driving so fast?
schnell(2)	Bitte sagen Sie mir so schnell wie möglich Bescheid.	Please let me know as soon as possible.
schnell(3)	Ich bin gleich fertig, ich muss nur noch schnell telefonieren.	I’ll be done soon, I just need to make a quick phone call.
das Schnitzel, -(1)	Bitte ein Schnitzel mit Kartoffeln und Salat.	Please, a schnitzel with potatoes and salad.
der Schnupfen(1)	Ich habe Schnupfen. Welches Medikament empfehlen Sie?	I have a cold. What medicine do you recommend?
die Schokolade(1)	Ich habe eine Tafel Schokolade gegessen.	I ate a bar of chocolate.
die Schokolade(2)	Bringen Sie mir bitte eine Tasse heiße Schokolade.	Please bring me a cup of hot chocolate.
schon(1)	Ist das Essen schon fertig?	Is the food ready yet?
schon(2)	Mirko ist erst fünf. Aber er kann schon lesen.	Mirko is only five, but he can already read.
schon(3)	Karl ist schon über 60. Aber er ist noch sehr fit.	Karl is already over 60, but he is still very fit.
schon(4)	Mach schon, ich kann nicht länger warten.	Hurry up, I can’t wait any longer.
schon(5)	Keine Sorge. Es wird schon klappen.	Don’t worry. It will work out.
schon(6)	Kommst du mit spazieren? – Ich hätte schon Lust, aber ich muss arbeiten.	Are you coming for a walk? – I’d like to, but I have to work.
schon(7)	Ich mag keine Kartoffeln. Und du? – Ich schon.	I don’t like potatoes. And you? – I do.
schön(1)	Ich finde eure Wohnung sehr schön.	I find your apartment very nice.
schön(2)	Es ist schön heute.	It’s nice today.
schön(3)	Wir wünschen Ihnen einen schönen Aufenthalt in Kiel.	We wish you a pleasant stay in Kiel.
schön(4)	Schöne Grüße von Herrn Meier.	Best regards from Mr. Meier.
schön(5)	Möchten Sie noch eine Tasse Kaffee? – Nein, danke schön.	Would you like another cup of coffee? – No, thank you.
schön(6)	Schön, dass du kommst.	Nice that you are coming.
schön(7)	Ich muss noch arbeiten. – Schön, dann bleiben wir zu Hause.	I still have to work. – Nice, then we will stay at home.
der Schrank, ¨-e(1)	Die Handtücher liegen im Schrank.	The towels are in the cupboard.
der Schreck, -en(1)	Ich habe einen großen Schreck bekommen.	I got a big scare.
schrecklich(1)	Heute ist eine schreckliche Hitze.	It’s an awful heat today.
schrecklich(2)	Das Restaurant war schrecklich voll.	The restaurant was terribly crowded.
schrecklich(3)	Ich finde dieses Kleid schrecklich.	I find this dress awful.
schrecklich(4)	Auf der Autobahn ist ein schrecklicher Unfall passiert.	There was a terrible accident on the highway.
schreiben, schreibt, schrieb, hat geschrieben(1)	Ich habe dir einen Brief geschrieben.	I wrote you a letter.
schreiben, schreibt, schrieb, hat geschrieben(2)	Ich schreibe dir eine E-Mail.	I am writing you an email.
schreiben, schreibt, schrieb, hat geschrieben(3)	Mein Kugelschreiber schreibt nicht mehr.	My pen no longer writes.
aufschreiben(1)	Ich habe mir deine Telefonnummer aufgeschrieben.	I wrote down your phone number.
das Schreiben, -(1)	Haben Sie mein Schreiben vom 3. März erhalten?	Did you receive my letter from March 3rd?
schreien, schreit, schrie, hat geschrien(1)	Kinder, hört bitte auf, so laut zu schreien. – Ich muss arbeiten.	Kids, please stop shouting so loudly. – I have to work.
schreien, schreit, schrie, hat geschrien(2)	Unser Baby hat heute Nacht viel geschrien.	Our baby cried a lot last night.
die Schrift, -en(1)	Ich kann leider deine Schrift nicht lesen.	Unfortunately, I cannot read your handwriting.
schriftlich(1)	Die schriftliche Prüfung dauert einen halben Tag.	The written exam lasts half a day.
schriftlich(2)	Wir brauchen von Ihnen eine schriftliche Bestätigung.	We need a written confirmation from you.
schriftlich(3)	Sie müssen sich schriftlich anmelden.	You need to register in writing.
der Schriftsteller, - (1)	Kennst du diese Schriftstellerin? Ich liebe ihre Bücher.	Do you know this female writer? I love her books.
der Schriftsteller, - (2)	Kennst du diesen Schriftsteller? Ich liebe seine Bücher.	Do you know this writer? I love his books.
der Schritt, -e(1)	Die Sprachschule ist nur ein paar Schritte von hier.	The language school is just a few steps from here.
der Schritt, -e(2)	Du musst der Anleitung Schritt für Schritt folgen.	You need to follow the instructions step by step.
der Schuh, -e(1)	Die neuen Schuhe sind mir zu eng.	The new shoes are too tight for me.
die Schuld(1)	Es ist nicht meine Schuld, dass das nicht geklappt hat.	It’s not my fault that it didn’t work out.
die Schuld(2)	Ich hatte einen Unfall. Aber ich war nicht schuld.	I had an accident. But I wasn’t at fault.
die Schulden (Pl.)(1)	Jetzt habe ich alle meine Schulden bezahlt.	Now I have paid all my debts.
schuldig(1)	Was bin ich Ihnen schuldig? – 50 Euro, bitte.	What do I owe you? – 50 euros, please.
die Schule, -n(1)	Meine Tochter geht schon in die Schule.	My daughter is already in school.
die Schule, -n(2)	Nächste Woche fängt die Schule wieder an.	School starts again next week.
die Schule, -n(3)	Die Schule ist gleich hier um die Ecke.	The school is right around the corner.
die Schularbeit, -en (A) (1)	Mein Sohn schreibt bei Schularbeiten immer gute Noten.	My son always gets good grades in school tests.
der Schüler, - (1)	In der Klasse sind 25 Schülerinnen.	There are 25 female students in the class.
der Schülerin, -nen (1)	Der Schüler ist krank.	The student is sick.
die Schulter, -n(1)	Ich habe Schmerzen in der rechten Schulter.	I have pain in my right shoulder.
die Schüssel, -n(1)	Gibst du mir bitte eine Schüssel für den Salat?	Can you give me a bowl for the salad?
schütteln, schüttelt, schüttelte, hat geschüttelt(1)	Die Flasche muss man vor dem Öffnen schütteln.	You need to shake the bottle before opening it.
schützen, schützt, schützte, hat geschützt(1)	Diese Impfung schützt vor Grippe.	This vaccine protects against the flu.
der Schutz(1)	Das ist ein guter Schutz gegen Kälte.	That’s a good protection against cold.
der Schutz(2)	Alle reden heute über den Schutz der Umwelt.	Everyone is talking about environmental protection today.
schwach(1)	Ich bin noch nicht gesund. Ich fühle mich noch sehr schwach.	I’m still not well. I still feel very weak.
schwach(2)	Die Tabletten sind zu schwach. Sie helfen nicht.	The tablets are too weak. They don’t help.
das Schwammerl, -n (A) (1)	Haben Sie frische Schwammerln?	Do you have fresh mushrooms?
schwanger(1)	Meine Frau ist im dritten Monat schwanger.	My wife is three months pregnant.
die Schwangerschaft, -en(1)	Sie dürfen während der Schwangerschaft nicht rauchen.	You may not smoke during pregnancy.
schweigen, schweigt, schwieg, hat geschwiegen(1)	Sie sprach viel, aber ihr Mann schwieg den ganzen Abend lang.	She talked a lot, but her husband stayed silent the whole evening.
schwer(1)	Der Koffer ist viel zu schwer.	The suitcase is way too heavy.
schwer(2)	Die Prüfung war schwer.	The exam was difficult.
schwer(3)	Das ist eine schwere Arbeit.	This is a hard job.
schwer(4)	Dieses Wort ist schwer zu erklären.	This word is hard to explain.
die Schwester, -n(1)	Ich habe eine ältere Schwester und einen jüngeren Bruder.	I have an older sister and a younger brother.
die Schwester, -n(2)	Schwester Anna hat mir eine Schmerztablette gegeben.	Sister Anna gave me a painkiller.
Schwieger- (1)	Wir besuchen morgen meine Schwiegereltern.	We are visiting my in-laws tomorrow.
Schwieger- (2)	Mein Schwiegervater ist Lehrer.	My father-in-law is a teacher.
Schwieger- (3)	Ich verstehe mich gut mit meiner Schwiegertochter.	I get along well with my daughter-in-law.
schwierig(1)	Die Prüfung war sehr schwierig.	The exam was very difficult.
die Schwierigkeit, -en(1)	Ich hatte große Schwierigkeiten, einen Parkplatz zu bekommen.	I had a lot of trouble finding a parking space.
schwimmen, schwimmt, schwamm, ist geschwommen(1)	Ich gehe regelmäßig schwimmen.	I go swimming regularly.
schwimmen, schwimmt, schwamm, ist geschwommen(2)	Kannst du schwimmen?	Can you swim?
das Schwimmbad, ¨-er(1)	Kommst du mit ins Schwimmbad?	Are you coming to the swimming pool?
schwitzen, schwitzt, schwitzte, hat geschwitzt(1)	Es war sehr heiß. Wir haben alle sehr geschwitzt.	It was very hot. We all sweated a lot.
der See, -n(1)	Unser Hotel war direkt am See.	Our hotel was right by the lake.
die See(1)	Im Sommer fahren wir immer an die See.	In summer, we always go to the sea.
sehen, sieht, sah, hat gesehen(1)	Ich sehe nicht gut. Ich brauche eine Brille.	I don’t see well. I need glasses.
sehen, sieht, sah, hat gesehen(2)	Ich habe einen schönen Film gesehen.	I watched a nice movie.
sehen, sieht, sah, hat gesehen(3)	Wir haben uns lange nicht gesehen.	We haven’t seen each other for a long time.
sehen, sieht, sah, hat gesehen(4)	Darf ich mal Ihren Ausweis sehen?	May I see your ID?
sehen, sieht, sah, hat gesehen(5)	Sieh mal! Es schneit.	Look! It’s snowing.
sehen, sieht, sah, hat gesehen(6)	Ich komme gleich wieder, ich muss mal schnell nach dem Essen sehen.	I’ll be right back, I need to quickly check the food.
sehen, sieht, sah, hat gesehen(7)	Was machst du im Urlaub? – Ich weiß noch nicht. Mal sehen.	What are you doing on vacation? – I don’t know yet. Let’s see.
sehen, sieht, sah, hat gesehen(8)	Du siehst deiner Mutter sehr ähnlich.	You look very much like your mother.
die Sehenswürdigkeit, -en(1)	Welche Sehenswürdigkeiten gibt es hier?	What sights are there here?
sehr(1)	Ich habe mich sehr über Ihren Besuch gefreut.	I was very happy about your visit.
sehr(2)	Hier ist Ihr Essen. - Danke sehr.	Here is your food. - Thank you very much.
sehr(3)	Das Wetter ist heute sehr schön.	The weather is very nice today.
die Seife, -n(1)	Hier gibt es keine Seife.	There is no soap here.
sein, ist, war, ist gewesen(1)	Ich bin Mechaniker.	I am a mechanic.
sein, ist, war, ist gewesen(2)	Das sind meine Kollegen.	These are my colleagues.
sein, ist, war, ist gewesen(3)	Ich bin müde.	I am tired.
sein, ist, war, ist gewesen(4)	Das Auto ist jetzt fünfzehn Jahre alt.	The car is now fifteen years old.
sein, ist, war, ist gewesen(5)	Heute ist Montag.	Today is Monday.
sein, ist, war, ist gewesen(6)	Der Termin beim Zahnarzt ist erst übermorgen.	The dentist appointment is not until the day after tomorrow.
sein, ist, war, ist gewesen(7)	Um 11 Uhr ist Pause.	There is a break at 11 o’clock.
sein, ist, war, ist gewesen(8)	Herr Müller ist in seinem Zimmer.	Mr. Müller is in his room.
sein, ist, war, ist gewesen(9)	Das Auto ist mir zu teuer.	The car is too expensive for me.
sein, ist, war, ist gewesen(10)	Das ist schwer zu verstehen.	That’s hard to understand.
sein, ist, war, ist gewesen(11)	Mir ist kalt.	I’m cold.
sein, ist, war, ist gewesen(12)	Mit Präposition wie: Das Licht ist an/aus.	With preposition like: The light is on/off.
seit(1)	Wir wohnen seit dem 1. März in Dortmund.	We have been living in Dortmund since March 1st.
seit(2)	Seit ich in Deutschland wohne, lerne ich Deutsch.	Since I have been living in Germany, I am learning German.
seitdem(1)	Ich bin vor zwei Jahren nach Deutschland gekommen. Seitdem lerne ich Deutsch.	I came to Germany two years ago. Since then, I’ve been learning German.
die Seite, -n(1)	Das hier ist die Goethestraße. Ich wohne auf der linken Seite.	This is Goethe Street. I live on the left side.
die Seite, -n(2)	Der Text steht auf Seite 20.	The text is on page 20.
der Sekretär, -e (1)	Der neue Sekretär hat sich gestern vorgestellt.	The new secretary introduced himself yesterday.
der Sekretärin, -nen (1)	Die Sekretärin hat die Anrufe entgegengenommen.	The secretary took the calls.
selb- (1)	Ich habe am selben Tag Geburtstag wie du.	I have the same birthday as you.
selbst(1)	Den Kuchen habe ich selbst gebacken.	I baked the cake myself.
selbst(2)	Sie will das selber machen.	She wants to do it herself.
selbstständig(1)	Jetzt bin ich angestellt. Früher war ich selbstständig.	I’m employed now. I was self-employed before.
selbstständig(2)	Wir suchen eine Sekretärin, die selbstständig arbeiten kann.	We are looking for a secretary who can work independently.
selbstverständlich(1)	Selbstverständlich sagen wir Ihnen sofort Bescheid.	Of course, we will let you know immediately.
selten(1)	Ich gehe ganz selten ins Kino.	I go to the cinema very rarely.
seltsam(1)	Es ist seltsam, dass mein Bruder noch nicht hier ist.	It’s strange that my brother isn’t here yet.
seltsam(2)	Sie hörte ein seltsames Geräusch.	She heard a strange noise.
das Semester, -(1)	Mein Neffe studiert im 7. Semester Medizin.	My nephew is studying medicine in the 7th semester.
das Seminar, -e(1)	Ich möchte dieses Seminar unbedingt besuchen.	I definitely want to attend this seminar.
die Semmel, -n (A) (1)	Ich hole schnell ein paar Semmeln zum Frühstück.	I’ll quickly get some rolls for breakfast.
senden, sendet, sendete/sandte, hat gesendet/gesandt(1)	Bitte senden Sie uns die Unterlagen per E-Mail.	Please send us the documents by email.
senden, sendet, sendete/sandte, hat gesendet/gesandt(2)	Können Sie uns die Post bitte nachsenden?	Can you please forward the mail to us?
der Sender, - (1)	Welchen Sender siehst du am liebsten?	Which channel do you like best?
der Sender, - (2)	Ich höre im Radio am liebsten Sender mit moderner Musik.	I like listening to channels with modern music on the radio.
die Sendung, -en(1)	Wir wiederholen die Sendung am 11. Mai.	We are repeating the broadcast on May 11th.
die Sendung, -en(2)	Ich warte auf eine Postsendung.	I am waiting for a mail delivery.
die Senioren (Pl.)(1)	Dieser Computerkurs ist für Senioren.	This computer course is for seniors.
senkrecht(1)	Ziehen Sie bitte eine senkrechte Linie.	Please draw a vertical line.
die Serie, -n(1)	Meine Tochter liebt es, im Fernsehen Serien zu schauen.	My daughter loves watching series on TV.
der Service(1)	Rufst du beim Pizza-Service an?	Are you calling the pizza service?
der Service(2)	Ich war mit dem Service in der Werkstatt nicht zufrieden.	I was not satisfied with the service at the workshop.
der Serviceangestellte, -n(1)	Ich bin Serviceangestellte von Beruf.	I work as a service employee.
die Serviceangestellte, -n (CH) (1)	Ich bin Serviceangestellte von Beruf.	I work as a service employee.
sichtbar(1)	Es gibt keine sichtbaren Verletzungen.	There are no visible injuries.
sichtbar(2)	Aber wir müssen das Bein trotzdem untersuchen.	But we still need to examine the leg.
siegen, siegt, siegte, hat gesiegt(1)	Die Mannschaft siegte mit 2:0.	The team won with 2:0.
der Sieg, -e(1)	Unsere Mannschaft hat gewonnen. Wir freuen uns über den Sieg.	Our team won. We are happy about the victory.
der Sieger, - (1)	Wer hat gewonnen? Wie heißt die Siegerin?	Who won? What’s the winner’s name?
die Siegerin, -nen (1)	Wer hat gewonnen? Wie heißt die Siegerin?	Who won? What’s the winner’s name?
(sich) siezen, siezt, siezte, hat gesiezt(1)	Obwohl sie sich schon lange kennen, siezten sie sich.	Although they have known each other for a long time, they still address each other formally.
singen, singt, sang, hat gesungen(1)	Ich singe gern.	I like to sing.
singen, singt, sang, hat gesungen(2)	Ich kann heute nicht singen, ich bin erkältet.	I can’t sing today; I have a cold.
sinken, sinkt, sank, ist gesunken(1)	Das Schiff ist vor der Küste gesunken.	The ship sank off the coast.
sinken, sinkt, sank, ist gesunken(2)	Der Preis ist um 3 % gesunken.	The price has dropped by 3%.
der Sinn(1)	Es hat keinen Sinn, noch ein Spiel zu beginnen. Es ist schon spät.	There is no point in starting another game. It’s already late.
sinnlos(1)	So ein sinnloses Buch habe ich schon lange nicht mehr gelesen.	I haven’t read such a pointless book in a long time.
sinnvoll(1)	Es funktioniert einfach nicht. Es ist sinnvoll, es noch einmal zu versuchen.	It just doesn’t work. It makes sense to try it again.
die Situation, -en(1)	Ich bin in einer schwierigen Situation.	I am in a difficult situation.
sitzen, sitzt, saß, hat/ist gesessen(1)	Wo möchten Sie sitzen? – Bitte ganz hinten.	Where would you like to sit? – Please, right at the back.
sitzen, sitzt, saß, hat/ist gesessen(2)	Die Jacke sitzt sehr gut.	The jacket fits very well.
der Sitz, -e(1)	Ich suche für meinen Sohn einen Sitz fürs Auto. Er ist erst drei Jahre alt.	I’m looking for a car seat for my son. He is only three years old.
der Ski/Schi, -er/- (1)	Gehen wir am Wochenende Ski laufen?	Shall we go skiing this weekend?
der Ski/Schi, -er/- (2)	Das sind aber schöne Skier!	Those are nice skis!
der Sessel, - (1)	Ich hätte gern einen bequemen Sessel.	I would like a comfortable armchair.
der Sessel, - (2)	Da hinten ist noch ein Sessel frei.	There is still an armchair free over there.
(sich) setzen, setzt, setzte, hat gesetzt(1)	Darf ich mich zu Ihnen setzen?	May I sit with you?
(sich) setzen, setzt, setzte, hat gesetzt(2)	Bitte setzen Sie sich, wohin Sie wollen!	Please sit wherever you like!
sicher(1)	Dieses Auto ist besonders sicher.	This car is particularly safe.
sicher(2)	Bist du sicher, dass die Bank heute geöffnet ist?	Are you sure the bank is open today?
sicher(3)	Das weiß ich ganz sicher.	I am absolutely sure of that.
die Sicherheit, -en(1)	Sicherheit ist für mich sehr wichtig.	Safety is very important to me.
sichern, sichert, sicherte, hat gesichert(1)	Du musst immer alle Daten im Computer sichern.	You should always back up all the data on the computer.
so(1)	Wie macht man das? – So!	How do you do that? – Like this!
so(2)	Sie müssen das so machen. Nicht so!	You have to do it like this. Not like that!
so(3)	Sie sind auch hier! So ein Zufall!	You are here too! What a coincidence!
so(4)	Ich melde mich, so schnell ich kann.	I’ll get in touch as soon as I can.
so(5)	Wann treffen wir uns? – So gegen 10 Uhr. Ist dir das recht?	When shall we meet? – Around 10 o’clock. Is that alright with you?
so(6)	Dauert es lange? – Eine Stunde oder so kann es schon dauern.	Does it take long? – It might take about an hour or so.
so(7)	Ich hatte kein Geld dabei. Da haben sie mich so hineingelassen.	I didn’t have any money with me. That’s why they let me in like that.
so(8)	So, jetzt bin ich fertig. Was machen wir jetzt?	Okay, I’m finished now. What do we do next?
so(9)	Fahren Sie bitte nicht so schnell!	Please don’t drive so fast!
so(10)	Meine Frau ist so groß wie ich.	My wife is as tall as I am.
so(11)	Was macht ihr denn so?	What are you up to?
sobald(1)	Sobald ich den Termin weiß, gebe ich Ihnen Bescheid.	As soon as I know the appointment, I’ll let you know.
die Socke, -n(1)	Im Winter brauche ich warme Socken.	In winter, I need warm socks.
sodass(1)	Der Zug hatte zwei Stunden Verspätung, sodass ich erst um 23 Uhr nach Hause kam.	The train was two hours late, so I didn’t get home until 11 PM.
das Sofa, -s(1)	Wir hätten gern ein modernes Sofa.	We would like a modern sofa.
sofort(1)	Warum sind Sie nicht sofort zum Arzt gegangen?	Why didn’t you go to the doctor right away?
sofort(2)	Karten für das Konzert bekommen Sie ab sofort im Kartenbüro.	You can get tickets for the concert immediately at the ticket office.
sogenannt- (1)	Studenten, die lange studieren, sind sogenannte Langzeitstudierende.	Students who study for a long time are called long-term students.
sogenannt- (2)	Wo bleiben denn deine sogenannten Freunde?	Where are your so-called friends?
sogar(1)	Auf dem Berg war es so kalt. Es hat sogar geschneit.	It was so cold on the mountain. It even snowed.
der Sohn, ¨-e(1)	Mein jüngster Sohn ist vier.	My youngest son is four.
solange(1)	Solange Sie Fieber haben, dürfen Sie auf keinen Fall arbeiten gehen.	As long as you have a fever, you must not go to work.
solch- (1)	Solche Schuhe finde ich toll.	I think such shoes are great.
sollen, soll, sollte, hat gesollt (1)	Wann soll ich kommen?	When should I come?
sollen, soll, sollte, hat gesollt (2)	Ich habe im Radio gehört, es soll morgen regnen.	I heard on the radio that it is supposed to rain tomorrow.
sollen, soll, sollte, hat gesollt (3)	Sollten Sie mit dem Vorschlag nicht einverstanden sein, rufen Sie mich an.	If you disagree with the proposal, please call me.
das Sonderangebot, -e(1)	Das ist ein Sonderangebot: 25 % reduziert.	This is a special offer: 25% off.
sondern(1)	Unser Besuch kommt nicht heute, sondern morgen.	Our visit will not be today, but tomorrow.
die Sonne(1)	Das Wetter ist schön. Die Sonne scheint.	The weather is nice. The sun is shining.
die Sonne(2)	Ich habe zu lange in der Sonne gelegen.	I stayed in the sun too long.
sonnig(1)	Das Wetter morgen: sonnig und warm.	The weather tomorrow: sunny and warm.
sonst(1)	Haben sie sonst noch einen Wunsch? – Nein, danke. Das ist alles.	Do you have any other wishes? – No, thank you. That’s all.
sonst(2)	Wir müssen jetzt gehen, sonst wird es zu spät.	We need to leave now, otherwise it will be too late.
sonst(3)	Heute ist der Chef nicht mehr da. Sonst ist er um diese Zeit immer im Büro.	Today the boss is not here anymore. Otherwise, he is always in the office at this time.
sorgen, sorgt, sorgte, hat gesorgt(1)	Wer sorgt denn für die Kinder?	Who is taking care of the children?
sorgen, sorgt, sorgte, hat gesorgt(2)	Können Sie bitte dafür sorgen, dass die Heizung funktioniert?	Can you please ensure that the heating works?
die Sorge, -n(1)	Um Ihre Zukunft brauchen Sie sich keine Sorgen zu machen.	You don’t need to worry about your future.
die Soße/Sauce, -n(1)	Gibst du mir bitte mal die Soße?	Can you please pass me the sauce?
das Souvenir, -s(1)	Ich habe ein paar Souvenirs aus dem Urlaub mitgebracht.	I brought back some souvenirs from the vacation.
soviel(1)	Soviel ich weiß, hat dieses Restaurant heute Ruhetag.	As far as I know, this restaurant is closed today.
so viel/so viel wie(1)	Ich habe so viel gegessen. Jetzt ist mir schlecht.	I ate so much. Now I feel sick.
so viel/so viel wie(2)	Ich verdiene nur halb so viel wie er.	I earn only half as much as he does.
sowieso(1)	Willst du mir den Brief mitgeben? Ich gehe sowieso zur Post.	Do you want to give me the letter? I’m going to the post office anyway.
sowohl … als auch(1)	Sowohl Sie als auch Ihre Frau müssen unterschreiben.	Both you and your wife must sign.
sozial(1)	Das System ist nicht sozial.	The system is not social.
sozial(2)	Es gibt viele soziale Probleme.	There are many social problems.
der Sozialarbeiter, - (1)	Die Sozialarbeiterin kommt einmal in der Woche.	The social worker comes once a week.
die Sozialarbeiterin, -nen (1)	Die Sozialarbeiterin kommt einmal in der Woche.	The social worker comes once a week.
spannend(1)	Das Spiel war spannend bis zur letzten Minute.	The game was exciting until the last minute.
sparen, spart, sparte, hat gespart(1)	Ein Auto ist mir zu teuer, ich muss sparen.	A car is too expensive for me; I need to save money.
sparen, spart, sparte, hat gespart(2)	Um Strom zu sparen, schalten wir die Heizung nachts aus.	To save electricity, we turn off the heating at night.
sparsam(1)	Wir haben fünf Kinder. Wir müssen sehr sparsam sein.	We have five children. We need to be very economical.
sparsam(2)	Mein Auto ist sehr sparsam. Es verbraucht nur 5 Liter auf 100 km.	My car is very economical. It consumes only 5 liters per 100 km.
der Spaß(1)	Meine Arbeit macht mir viel Spaß.	My work is a lot of fun.
der Spaß(2)	Viel Spaß bei der Party!	Have fun at the party!
spät(1)	Wie spät ist es?	What time is it?
spät(2)	Es ist schon spät, ich muss gehen.	It’s already late; I need to go.
spät(3)	Ich muss mich beeilen. Sonst komme ich zu spät.	I have to hurry. Otherwise, I will be late.
spät(4)	Sonntags stehen wir immer spät auf.	On Sundays, we always get up late.
spät(5)	Am späten Nachmittag ist der Verkehr besonders stark.	In the late afternoon, traffic is particularly heavy.
spät(6)	Können Sie später noch mal anrufen?	Can you call back later?
spät(7)	Was willst du denn später mal werden?	What do you want to be later?
spätestens(1)	Ich muss spätestens um 9 Uhr bei der Arbeit sein.	I must be at work by 9 o’clock at the latest.
spazieren gehen, geht spazieren, ging spazieren, ist spazieren gegangen(1)	Wir gehen sonntags immer spazieren.	We always go for a walk on Sundays.
der Spaziergang, ¨-e(1)	Abends mache ich oft einen Spaziergang durch das Viertel.	In the evenings, I often take a walk through the neighborhood.
speichern, speichert, speicherte, hat gespeichert(1)	Sie müssen die Datei speichern.	You need to save the file.
Speise-/Speise, -n(1)	Als Vorspeise nehme ich eine Suppe, aber dafür nehme ich keine Nachspeise.	I will have soup as a starter but no dessert.
die Speisekarte, -n(1)	Bitte, die Speisekarte.	Please, the menu.
der Speisewagen, - (1)	Wo ist der Speisewagen?	Where is the dining car?
Spezial-(1)	Ich brauche eine Spezialpflege für trockenes Haar.	I need a special treatment for dry hair.
der Spezialist, -en (1)	Mein Arzt hat mich zur Spezialistin geschickt.	My doctor referred me to the specialist.
die Spezialistin, -nen (1)	Mein Arzt hat mich zur Spezialistin geschickt.	My doctor referred me to the specialist.
speziell(1)	Ich suche einen ganz speziellen Ring für meine Freundin.	I’m looking for a very special ring for my girlfriend.
der Spiegel, - (1)	Ich möchte gerne sehen, wie mein Kleid sitzt. Hast du einen Spiegel?	I would like to see how my dress fits. Do you have a mirror?
spielen, spielt, spielte, hat gespielt(1)	Wir haben einen großen Garten, da können die Kinder spielen.	We have a large garden where the children can play.
spielen, spielt, spielte, hat gespielt(2)	Am Sonntag spielen wir gegen die Fußballmannschaft der Nachbarschule.	On Sunday, we play against the neighboring school’s football team.
spielen, spielt, spielte, hat gespielt(3)	Spielen Sie ein Instrument?	Do you play an instrument?
spielen, spielt, spielte, hat gespielt(4)	Spielen Sie Karten?	Do you play cards?
das Spiel, -e(1)	Monopoly ist ein ganz bekanntes Spiel.	Monopoly is a very well-known game.
das Spiel, -e(2)	Nach 20 Minuten stand das Spiel 2:1.	After 20 minutes, the score was 2:1.
der Spieler, - (1)	Für dieses Spiel braucht man zwei bis vier Spieler.	This game requires two to four players.
die Spielerin, -nen (1)	Beim Fußball gibt es elf Spieler.	In football, there are eleven players.
der Spielplatz, ¨-e (1)	Die Kinder sind auf dem Spielplatz.	The children are on the playground.
das Spielzeug, -e (1)	Zu Weihnachten wünschen sich die Kinder vor allem Spielzeug.	For Christmas, the children mainly wish for toys.
spitz(1)	Der Bleistift ist nicht spitz.	The pencil is not sharp.
der Sport(1)	Für Sport interessiere ich mich sehr.	I am very interested in sports.
der Sport(2)	Ich mache viel Sport.	I do a lot of sports.
die Sportart, -en(1)	Welche Sportart findest du am besten?	Which sport do you like best?
der Sportler, - (1)	Sie ist eine gute Sportlerin.	She is a good athlete.
die Sportlerin, -nen (1)	Sie ist eine gute Sportlerin.	She is a good athlete.
sportlich(1)	Ich bin nicht sehr sportlich.	I am not very athletic.
sportlich(2)	Ich mag bequeme und sportliche Kleidung.	I like comfortable and sporty clothing.
die Sprache, -n(1)	Franco spricht mehrere Sprachen.	Franco speaks several languages.
die Fremdsprache, -n(1)	Ich spreche drei Fremdsprachen.	I speak three foreign languages.
die Muttersprache, -n(1)	Was ist Ihre Muttersprache?	What is your native language?
die Zweitsprache, -n(1)	Deutsch ist seine Zweitsprache.	German is his second language.
sprechen, spricht, sprach, hat gesprochen(1)	Können Sie bitte etwas lauter sprechen?	Can you please speak a little louder?
sprechen, spricht, sprach, hat gesprochen(2)	Jean spricht sehr gut Deutsch.	Jean speaks German very well.
sprechen, spricht, sprach, hat gesprochen(3)	Ich möchte nicht darüber sprechen.	I don’t want to talk about it.
sprechen, spricht, sprach, hat gesprochen(4)	Die Bundeskanzlerin spricht heute Abend im Fernsehen.	The Chancellor will speak on TV this evening.
sprechen, spricht, sprach, hat gesprochen(5)	Kann ich bitte Herrn Müller sprechen?	May I speak to Mr. Müller, please?
die Sprechstunde, -n (1)	Frau Dr. Berger hat von 8 bis 12 Uhr Sprechstunde.	Dr. Berger has office hours from 8 AM to 12 PM.
springen, springt, sprang, ist gesprungen(1)	Wir waren im Schwimmbad. Mein Sohn ist immer wieder ins Wasser gesprungen.	We were at the swimming pool. My son kept jumping into the water.
springen, springt, sprang, ist gesprungen(2)	Wie weit bist du heute gesprungen? – 3,40 m.	How far did you jump today? – 3.40 m.
die Spritze, -n(1)	Ich habe heute vom Arzt eine Spritze gegen die Schmerzen bekommen.	I received an injection from the doctor today for the pain.
spülen, spült, spülte, hat gespült(1)	Hast du das Geschirr gespült?	Did you wash the dishes?
spülen, spült, spülte, hat gespült(2)	Spülen Sie bitte jetzt den Mund aus.	Please rinse your mouth now.
die Spur, -en(1)	Fahren Sie bitte auf der linken Spur, wenn Sie schneller fahren.	Please drive in the left lane if you are going faster.
spüren, spürt, spürte, hat gespürt(1)	Wo tut es weh? Spüren Sie das hier?	Where does it hurt? Do you feel this here?
das Stadion, Stadien(1)	Ich möchte am Samstag ins Stadion gehen. Da spielt meine Mannschaft.	I want to go to the stadium on Saturday. My team is playing there.
die Stadt, ¨-e(1)	Heidelberg ist eine alte Stadt.	Heidelberg is an old city.
die Stadt, ¨-e(2)	Ich wohne lieber auf dem Land als in der Stadt.	I prefer living in the countryside to living in the city.
die Stadt, ¨-e(3)	Gehst du mit mir in die Stadt?	Will you go to the city with me?
städtisch(1)	Ich gehe gern in die städtische Bibliothek.	I like going to the city library.
der Stadtplan, ¨-e(1)	Haben Sie einen Stadtplan?	Do you have a city map?
stammen, stammt, stammte, hat gestammt(1)	Ich stamme aus einer kleinen Stadt an der Donau.	I come from a small town on the Danube.
ständig(1)	Ich habe schon ein paar Mal bei meiner Freundin angerufen. Es ist ständig besetzt.	I have called my friend a few times. It is constantly busy.
der Standpunkt, -e(1)	Von seinem Standpunkt aus hat er recht.	From his point of view, he is right.
der Star, -s(1)	Diese Sängerin ist ein großer Star in Deutschland.	This singer is a big star in Germany.
stark(1)	Der Kaffee ist sehr stark.	The coffee is very strong.
stark(2)	Am späten Nachmittag ist der Verkehr besonders stark.	Traffic is particularly heavy in the late afternoon.
stark(3)	Ich habe starke Kopfschmerzen.	I have a severe headache.
stark(4)	Können Sie mir kein stärkeres Mittel verschreiben?	Can you prescribe me a stronger remedy?
stark(5)	Es hat stark geregnet.	It rained heavily.
starten, startet, startete, ist gestartet(1)	Das Flugzeug ist pünktlich gestartet.	The plane started on time.
der Start, -s(1)	Bleiben Sie bitte während des Starts sitzen.	Please remain seated during takeoff.
die Station, -en(1)	Sie müssen an der nächsten Station aussteigen.	You have to get off at the next station.
die Station, -en(2)	Meine Nachbarin liegt auf Station III.	My neighbor is on ward III.
die Statistik, -en(1)	Die Statistik zeigt, dass jeder zweite ein Fahrrad besitzt.	The statistics show that every second person owns a bicycle.
statistisch(1)	Die statistischen Ergebnisse zeigen eine gute Entwicklung.	The statistical results show a good development.
statt(1)	Kann ich diese Woche statt Donnerstag am Freitag kommen?	Can I come on Friday instead of Thursday this week?
stattfinden, findet statt, fand statt, hat stattgefunden(1)	Das Spiel findet auch bei Regen statt.	The game will take place even if it rains.
der Stau, -s(1)	Auf der A3 gibt es wegen eines Unfalls 5 km Stau.	There is a 5 km traffic jam on the A3 due to an accident.
der Stau, -s(2)	Wir standen eine Stunde im Stau.	We were stuck in traffic for an hour.
der Staub(1)	Ich habe überall Staub gewischt.	I dusted everywhere.
staubsaugen, staubsaugt, staubsaugte, hat gestaubsaugt(1)	Ich muss heute in meiner Wohnung noch staubsaugen.	I still need to vacuum in my apartment today.
stechen, sticht, stach, hat gestochen(1)	Stefan wird beim Zelten immer von den Mücken gestochen.	Stefan always gets bitten by mosquitoes while camping.
stecken, steckt, steckte, hat gesteckt(1)	Wo ist denn mein Pass? Ich hatte ihn doch in die Handtasche gesteckt.	Where is my passport? I put it in my handbag.
stecken, steckt, steckte, hat gesteckt(2)	Du kannst reingehen. Der Schlüssel steckt.	You can go in. The key is in the lock.
stecken, steckt, steckte, hat gesteckt(3)	Die Zeitung steckt im Briefkasten.	The newspaper is in the mailbox.
die Steckdose, -n(1)	Es gibt drei Steckdosen in diesem Zimmer.	There are three sockets in this room.
der Stecker, - (1)	Der Stecker passt nicht in diese Steckdose.	The plug doesn’t fit into this socket.
stehen, steht, stand, hat/ist gestanden(1)	In meinem Beruf muss ich viel stehen.	In my job, I have to stand a lot.
stehen, steht, stand, hat/ist gestanden(2)	Als wir kamen, stand das Essen schon auf dem Tisch.	When we arrived, the food was already on the table.
stehen, steht, stand, hat/ist gestanden(3)	Der Bus steht schon an der Haltestelle.	The bus is already at the stop.
stehen, steht, stand, hat/ist gestanden(4)	Was steht heute in der Zeitung?	What’s in the newspaper today?
stehen, steht, stand, hat/ist gestanden(5)	Nach 20 Minuten stand das Spiel 1:1.	After 20 minutes, the score was 1:1.
steil(1)	Die Straße zu unserem Haus ist sehr steil.	The road to our house is very steep.
der Stein, -e(1)	Die Kinder werfen Steine ins Wasser.	The children are throwing stones into the water.
die Stelle, -n(1)	Wir treffen uns hier an dieser Stelle.	We’ll meet here at this place.
die Stelle, -n(2)	Ich habe eine neue Stelle.	I have a new job.
die Stelle, -n(3)	Diese Stelle in seinem Brief ist mir nicht ganz klar.	This part of his letter is not quite clear to me.
die Stelle, -n(4)	An Ihrer Stelle würde ich den Vertrag nicht unterschreiben.	If I were you, I wouldn’t sign the contract.
stellen, stellt, stellte, hat gestellt(1)	Stell das Bier in den Kühlschrank!	Put the beer in the fridge!
stellen, stellt, stellte, hat gestellt(2)	Ich hole noch Milch. Stell dich bitte schon mal in die Schlange an der Kasse.	I’ll get some milk. Please stand in line at the register.
stellen, stellt, stellte, hat gestellt(3)	Wo kann ich mein Auto hinstellen?	Where can I park my car?
stellen, stellt, stellte, hat gestellt(4)	Würden Sie das Radio bitte etwas leiser stellen?	Could you please turn the radio down a bit?
stellen, stellt, stellte, hat gestellt(5)	Haben Sie einen Moment Zeit? Wir möchten Ihnen ein paar Fragen stellen.	Do you have a moment? We would like to ask you a few questions.
stellen, stellt, stellte, hat gestellt(6)	Ich habe den Wecker auf 5 Uhr gestellt.	I set the alarm clock for 5 o’clock.
der Stempel, - (1)	Der Poststempel trägt das Datum von letzter Woche. Das Paket war lange unterwegs.	The postmark is from last week. The package was on the way for a long time.
sterben, stirbt, starb, ist gestorben(1)	Mein Kollege kommt heute nicht. Sein Vater ist gestern gestorben.	My colleague is not coming today. His father passed away yesterday.
der Stern, -e(1)	Heute sieht man viele Sterne am Himmel.	Tonight, you can see many stars in the sky.
die Steuer, -n(1)	Wir müssen immer mehr Steuern zahlen.	We have to pay more and more taxes.
der Steward, -s(1)	Die Stewardess bringt das Mittagessen.	The stewardess is bringing the lunch.
die Stewardess, -en(1)	Die Stewardess bringt das Mittagessen.	The stewardess is bringing the lunch.
der Stift, -e(1)	Kannst du mir bitte einen Stift geben?	Can you please give me a pen?
der Stil, -e(1)	Ihr Stil ist sehr elegant.	Her style is very elegant.
der Stil, -e(2)	Das Gebäude gefällt mir. Welcher Baustil ist das?	I like the building. What architectural style is it?
stilistisch(1)	Der Text ist stilistisch sehr schön.	The text is stylistically very beautiful.
still(1)	Sei doch mal einen Moment still!	Please be quiet for a moment!
still(2)	Maria kann nicht still sitzen.	Maria cannot sit still.
stehen bleiben(1)	Bitte bleiben Sie stehen.	Please stay standing.
stehen bleiben(2)	Meine Uhr ist stehen geblieben.	My watch has stopped.
stehlen, stiehlt, stahl, hat gestohlen(1)	Gestern hat mir jemand im Zug meine Uhr gestohlen.	Yesterday someone stole my watch on the train.
steigen, steigt, stieg, ist gestiegen(1)	Die Preise für Milch und Gemüse sind schon wieder gestiegen.	The prices for milk and vegetables have gone up again.
steigen, steigt, stieg, ist gestiegen(2)	Gegen Abend ist das Fieber wieder gestiegen.	In the evening, the fever went up again.
der Stiefel, - (1)	Ich habe mir für den Winter ein Paar warme Stiefel gekauft.	I bought a pair of warm boots for winter.
die Stiege, -n (A) → D, CH: Treppe (1)	Wo ist die Toilette? – Die Stiege hoch und dann links.	Where is the toilet? – Up the stairs and then left.
die Stiege, -n (A) → D, CH: Treppe (2)	Meine Oma kann nicht gut Stiegen steigen.	My grandma can’t climb stairs well.
das Stiegenhaus, ¨-er (A) → D, CH: Treppenhaus (1)	Im Stiegenhaus ist kein Licht.	There is no light in the stairwell.
die Stimme, -n(1)	Ich habe dich sofort an der Stimme erkannt.	I recognized you immediately by your voice.
stimmen, stimmt, stimmte, hat gestimmt(1)	Meine Adresse stimmt nicht mehr.	My address is no longer correct.
stimmen, stimmt, stimmte, hat gestimmt(2)	Das Wetter in Deutschland könnte besser sein. – Das stimmt.	The weather in Germany could be better. – That’s true.
die Stimmung, -en(1)	Es war eine tolle Party. Die Stimmung war sehr gut.	It was a great party. The atmosphere was very good.
stinken, stinkt, stank, hat gestunken(1)	Was stinkt denn hier so? – Das ist der Fisch. Er ist nicht mehr frisch.	What smells here? – It’s the fish. It’s not fresh anymore.
der Stock → D, CH: Etage(1)	Das Büro ist im 3. Stock, Zimmer 305.	The office is on the 3rd floor, Room 305.
das Stockwerk, -e(1)	Das Gebäude hat zwanzig Stockwerke.	The building has twenty floors.
der Stoff, -e(1)	Was für ein Stoff ist das? – Wolle.	What kind of fabric is this? – Wool.
der Stoff, -e(2)	In manchen Farben sind giftige Stoffe.	Some colors contain toxic substances.
stolz(1)	Ich bin stolz auf dich. Das hast du sehr gut gemacht.	I am proud of you. You did very well.
stoppen, stoppt, stoppte, hat gestoppt(1)	Die Polizei hat mich gestoppt, weil ich bei Rot über die Ampel gefahren bin.	The police stopped me because I ran a red light.
stören, stört, störte, hat gestört(1)	Darf ich Sie einen Augenblick stören?	May I bother you for a moment?
stören, stört, störte, hat gestört(2)	Du kannst das Radio anlassen. Das stört mich nicht.	You can leave the radio on. It doesn’t bother me.
die Störung, -en(1)	Entschuldigen Sie bitte die Störung.	Please excuse the interruption.
(sich) stoßen, stößt, stieß, hat gestoßen(1)	Wie haben Sie sich denn verletzt? – Ich habe mich an der Autotür gestoßen.	How did you get injured? – I bumped into the car door.
die Strafe, -n(1)	Schwarzfahren kostet 60 Euro Strafe.	Riding without a ticket costs a 60 euro fine.
strafbar(1)	Was du da machst, ist strafbar.	What you’re doing is punishable by law.
der Strafzettel, - (1)	So ein Pech! Ich habe einmal falsch geparkt und sofort einen Strafzettel bekommen.	What bad luck! I parked incorrectly once and immediately received a parking ticket.
der Strand, ¨-e(1)	Im Urlaub bin ich am liebsten am Strand.	On vacation, I prefer to be at the beach.
die Straße, -n(1)	Wir wohnen in einer sehr kleinen Straße.	We live on a very small street.
die Straße, -n(2)	Unser Haus ist eine Straße weiter.	Our house is one street over.
die Straßenbahn, -en (D, A) → CH: Tram(1)	Fahren wir mit der Straßenbahn oder der U-Bahn?	Should we take the tram or the subway?
die Strecke, -n(1)	Sind Sie die ganze Strecke zu Fuß gegangen?	Did you walk the whole distance?
die Strecke, -n(2)	Auf der Strecke München – Salzburg: 8 km Stau.	On the route from Munich to Salzburg: 8 km traffic jam.
die Strecke, -n(3)	Ich möchte nach Hamburg fahren. Können Sie mir sagen, welche Strecke am besten ist?	I want to go to Hamburg. Can you tell me which route is the best?
das Streichholz, ¨-er → Zündholz; A: Zünder(1)	Ich hätte gern eine Schachtel Streichhölzer.	I would like a box of matches.
streiken, streikt, streikte, hat gestreikt(1)	Die Arbeiter streiken für höhere Löhne.	The workers are on strike for higher wages.
der Streik, -s(1)	Es gab einen Streik am Flughafen. Deshalb hatte unsere Maschine Verspätung.	There was a strike at the airport. That’s why our flight was delayed.
(sich) streiten, streitet, stritt, hat gestritten(1)	Die Kinder streiten sich oft.	The children often argue.
der Streit(1)	Ich möchte keinen Streit mit den Nachbarn.	I don’t want any conflict with the neighbors.
streng(1)	Unsere Tochter hat einen sehr strengen Lehrer.	Our daughter has a very strict teacher.
der Stress(1)	Ich habe bei der Arbeit viel Stress.	I have a lot of stress at work.
der Strom(1)	Wie kann ich im Haushalt Strom sparen?	How can I save electricity at home?
der Strumpf, ¨-e(1)	Wo sind meine roten Strümpfe?	Where are my red stockings?
das Stück/-stück, -e(1)	Ich nehme zwei Stück Zucker in den Kaffee.	I take two pieces of sugar in my coffee.
das Stück/-stück, -e(2)	Möchten Sie noch ein Stück Kuchen?	Would you like another piece of cake?
das Stück/-stück, -e(3)	Was kosten die Kulis? – Ein Euro pro Stück.	How much are the pens? – One euro each.
das Stück/-stück, -e(4)	Ich begleite dich ein Stück.	I’ll walk with you for a while.
das Stück/-stück, -e(5)	Er spielt in dem Stück die Hauptrolle.	He plays the lead role in the play.
die Studie, -n(1)	Wir führen eine Studie über Arbeitslosigkeit durch.	We are conducting a study on unemployment.
die Studie, -n(2)	Eine aktuelle Studie zeigt, dass die Umweltverschmutzung zunimmt.	A current study shows that environmental pollution is increasing.
studieren, studiert, studierte, hat studiert(1)	Mein Sohn will Medizin studieren.	My son wants to study medicine.
studieren, studiert, studierte, hat studiert(2)	Ich studiere in Mainz.	I am studying in Mainz.
der Student, -en(1)	Schüler und Studenten zahlen die Hälfte.	Students and pupils pay half.
die Studentin, -nen(1)	Schüler und Studenten zahlen die Hälfte.	Students and pupils pay half.
der Studierende, -n(1)	Zehn Studierende besuchen das Seminar.	Ten students are attending the seminar.
die Studierende, -n(1)	Zehn Studierende besuchen das Seminar.	Ten students are attending the seminar.
das Studium, Studien(1)	Sie brauchen für diese Stelle ein abgeschlossenes Studium.	You need a completed degree for this position.
das Studio, -s(1)	Zu Gast im Studio sind heute ...	Today’s guests in the studio are ...
die Stufe, -n(1)	Vorsicht, Stufe!	Watch out, step!
die Stufe, -n(2)	Die Volkshochschule bietet Sprachkurse auf verschiedenen Stufen an.	The adult education center offers language courses at various levels.
der Stuhl, ¨-e(1)	Da hinten ist noch ein Stuhl frei.	There is still a free chair back there.
stumm(1)	Stell bitte dein Handy leise oder auf stumm.	Please put your phone on silent or mute.
die Stunde, -n(1)	Ich bin in einer Stunde wieder zurück.	I’ll be back in an hour.
die Stunde, -n(2)	Wir haben heute nur vier Stunden Schule.	Today we have only four hours of school.
die Stunde, -n(3)	Ich warte seit zwei Stunden auf dich.	I have been waiting for you for two hours.
der Sturm, ¨-e(1)	Im Radio haben sie Regen und Sturm angesagt.	The radio forecasted rain and storm.
stürzen, stürzt, stürzte, ist gestürzt(1)	Ich bin auf der Straße gestürzt und habe mir den Fuß gebrochen.	I fell on the street and broke my foot.
stürzen, stürzt, stürzte, ist gestürzt(2)	Bitte pass auf der Treppe auf, dass du nicht hinunterstürzt!	Please be careful on the stairs so you don’t fall down!
suchen, sucht, suchte, hat gesucht(1)	Ich suche meine Brille.	I’m looking for my glasses.
suchen, sucht, suchte, hat gesucht(2)	Wir suchen eine größere Wohnung.	We are looking for a larger apartment.
suchen, sucht, suchte, hat gesucht(3)	Wen suchen Sie?	Who are you looking for?
die Sucht, ¨-e(1)	Die Sucht nach Medikamenten nimmt zu.	Addiction to medication is increasing.
die Sucht, ¨-e(2)	Er kämpft gegen seine Alkoholsucht.	He is fighting against his alcohol addiction.
die Sucht, ¨-e(3)	Das Internet kann zur Sucht werden.	The internet can become an addiction.
süchtig(1)	Ich bin süchtig nach Schokolade.	I am addicted to chocolate.
süchtig(2)	Fernsehen kann süchtig machen.	Watching TV can be addictive.
das Suchtmittel, - (1)	Manche Medikamente sind auch Suchtmittel.	Some medications are also addictive substances.
die Summe, -n(1)	Die Summe scheint mir zu hoch!	The total seems too high!
super(1)	Das war ein super Film!	That was a great movie!
super(2)	Er kann super tanzen.	He can dance really well.
super(3)	Weißt du was? Ich komme mit. – Super!	You know what? I’ll come along. – Great!
der Supermarkt, ¨-e(1)	Donnerstags gehe ich immer in den Supermarkt.	I always go to the supermarket on Thursdays.
die Suppe, -n(1)	Schmeckt dir die Suppe?	Do you like the soup?
süß(1)	Ich esse gern süße Sachen.	I like to eat sweet things.
süß(2)	Das ist aber ein süßes Baby!	What a cute baby!
das Symbol, -e(1)	Das Herz ist ein Symbol für die Liebe.	The heart is a symbol of love.
das Symbol, -e(2)	Auf dem Bildschirm finden Sie viele Symbole.	You will find many symbols on the screen.
sympathisch(1)	Ich finde unsere neue Kollegin sehr sympathisch.	I find our new colleague very likeable.
das System, -e(1)	Welches Betriebssystem hast du?	What operating system do you have?
das System, -e(2)	Ich kenne Ihr System nicht. Können Sie es mir erklären?	I don’t know your system. Can you explain it to me?
die Szene, -n(1)	In dieser Szene des Films stirbt der	In this scene of the film, the...
