ab	Ab morgen muss ich arbeiten.	I have to work from tomorrow.
aber	Ich bin oft im Büro, aber nur für wenige Stunden.	I am often in the office, but only for a few hours.
abfahren	Wir fahren um zwölf Uhr ab.	We leave at twelve o'clock.
die Abfahrt	Vor der Abfahrt rufe ich an.	Before departure, I'll call.
abgeben	Ich muss meine Schlüssel abgeben.	I have to hand in my keys.
abholen(1)	Wann kann ich den Schrank bei dir abholen?	When can I pick up the cabinet from you?
abholen(2)	Wir müssen noch meinen Bruder abholen.	We still need to pick up my brother.
der Absender	Da ist ein Brief für dich ohne Absender.	There is a letter for you without a sender.
Achtung	Achtung! Das dürfen Sie nicht tun.	Attention! You must not do that.
die Adresse,-en	Können Sie mir seine Adresse sagen?	Could you tell me his address?
all-(1)	Alles Gute!	All the best!
all-(2)	Das ist alles.	That's all.
all-(3)	Sind alle da?	Is everyone here?
all-(4)	Alle Freunde kommen.	All friends are coming.
all-(5)	Hast du alles?	Do you have everything?
allein	Er kommt allein.	He comes alone.
also(1)	Also, es ist so: …	Well, it is like this: …
also(2)	Er hat Zeit, also muss er uns helfen.	He has time, so he has to help us.
alt(1)	Wie alt sind Sie?	How old are you?
alt(2)	Sie sehen aber nicht so alt aus.	But you don't look that old.
alt(3)	Mein Auto ist schon sehr alt.	My car is already very old.
alt(4)	Wir wohnen in einem sehr alten Haus.	We live in a very old house.
alt(5)	Köln ist eine alte Stadt.	Cologne is an old city.
das Alter	Alter: 26 Jahre.	Age: 26 years.
an(1)	Fahren Sie an der nächsten Straße nach rechts.	Turn right at the next street.
an(2)	Wir treffen uns am Bahnhof.	We meet at the train station.
an(3)	Am nächsten Montag geht es leider nicht.	Sorry, it won't work next Monday.
anbieten	Was darf ich dir anbieten?	What can I offer you?
das Angebot, -e	Heute sind Sportschuhe im Angebot.	Today, sports shoes are on sale.
ander-	Willst du diese Jacke?	Do you want this jacket?
ander-	– Nein, ich möchte die andere.	– No, I want the other one.
anfangen(1)	Hier fängt die Bahnhofstraße an.	Here, Bahnhofstraße starts.
anfangen(2)	Der Unterricht fängt gleich an.	The class is about to start.
der Anfang	Sie wohnt am Anfang der Straße.	She lives at the beginning of the street.
der Anfang	Wir machen Anfang Juli Urlaub.	We're going on vacation in early July.
anklicken	Da musst du dieses Wort anklicken.	You need to click on this word.
ankommen	Wann kommt dieser Zug in Hamburg an?	When does this train arrive in Hamburg?
die Ankunft	Auf diesem Plan steht nur die Ankunft(-szeit) der Züge.	This plan only shows the arrival time of the trains.
ankreuzen	Auf dem Formular müssen Sie an mehreren Stellen etwas ankreuzen.	On the form, you need to check several places.
anmachen	Mach bitte das Licht an!	Please turn on the light.
(sich) anmelden	Wo kann ich mich anmelden?	Where can I register?
die Anmeldung	Eine Anmeldung für diesen Kurs ist nicht mehr möglich.	Registration for this course is no longer possible.
die Anrede	Schreiben Sie auch eine Anrede und einen Gruß.	Also, write a salutation and a closing.
anrufen(1)	Kann man Sie anrufen?	Can one call you?
anrufen(2)	Peter ruft kurz seine Freundin an.	Peter quickly calls his girlfriend.
der Anruf, -e	Sie bekommt viele Anrufe auf ihrem Handy.	She receives many calls on her cell phone.
der Anrufbeantworter	Wir sind im Moment nicht da. Sprechen Sie bitte auf den Anrufbeantworter.	We are not available at the moment. Please leave a message on the answering machine.
die Ansage, -n	Hören Sie die Ansagen.	Listen to the announcements.
der Anschluss(1)	In Mannheim haben Sie Anschluss nach Saarbrücken.	In Mannheim, you have a connection to Saarbrücken.
der Anschluss(2)	Ist das die Anmeldung für einen Telefonanschluss?	Is this the registration for a telephone connection?
an sein	Heute Nacht war das Licht an.	The light was on last night.
antworten	Er antwortet nicht.	He does not answer.
die Antwort, -en	Er gibt leider keine Antwort.	Unfortunately, he gives no answer.
die Anzeige, -n	Ich habe Ihre Anzeige in der Zeitung gelesen.	I read your advertisement in the newspaper.
(sich) anziehen	Ich muss mich noch anziehen.	I still need to get dressed.
das Apartment, -s	Wir haben ein Apartment gemietet.	We rented an apartment.
der Apfel, -Ä	Ein Pfund Äpfel bitte.	A pound of apples, please.
der Appetit	Guten Appetit!	Enjoy your meal!
arbeiten	Wo arbeiten Sie?	Where do you work?
die Arbeit, -en	Mein Bruder sucht Arbeit.	My brother is looking for work.
arbeitslos	Es gibt bei uns viele Leute, die schon lange arbeitslos sind.	There are many people here who have been unemployed for a long time.
der Arbeitsplatz, -ä, e	An meinem Arbeitsplatz fehlt ein Drucker.	A printer is missing at my workplace.
der Arm, -e	Mein Arm tut weh.	My arm hurts.
der Arzt, -Ä, e	Morgen habe ich einen Termin bei meiner Ärztin.	I have an appointment with my doctor tomorrow.
auch	Ich bin auch Spanier.	I am also Spanish.
auf(1)	Die Kinder spielen auf der Straße.	The children are playing on the street.
auf(2)	Auf Wiedersehen.	Goodbye.
auf sein	Du brauchst den Schlüssel nicht. Die Wohnung ist auf.	You don't need the key. The apartment is unlocked.
aufstehen(1)	Ich muss immer um vier Uhr aufstehen.	I always have to get up at four o'clock.
aufstehen(2)	Soll ich aufstehen?	Should I get up?
der Aufzug, -ü, e	In diesem Haus gibt es keinen Aufzug.	There is no elevator in this building.
das Auge, -n	Er hat blaue Augen.	He has blue eyes.
aus	Er kommt aus Brasilien.	He comes from Brazil.
der Ausflug	Morgen machen wir einen Ausflug nach Heidelberg.	Tomorrow we are going on a trip to Heidelberg.
ausfüllen	Füllen Sie bitte dieses Formular aus.	Please fill out this form.
der Ausgang	Wo ist der Ausgang?	Where is the exit?
die Auskunft, -ü, e	Können Sie mir eine Auskunft geben?	Can you give me information?
das Ausland	Fahren Sie ins Ausland?	Are you going abroad?
der Ausländer, -	Sind Sie Ausländerin?	Are you a foreigner?
ausländisch	Leider habe ich nur ausländisches Geld.	Unfortunately, I only have foreign money.
ausmachen	Mach bitte das Licht aus!	Please turn off the light.
die Aussage, -n	Ist die Aussage richtig oder falsch?	Is the statement correct or incorrect?
aussehen	Das sieht schön aus.	That looks nice.
aus sein(1)	Das Licht ist aus.	The light is off.
aus sein(2)	Die Schule ist aus.	The school is over.
aussteigen	Wo muss ich aussteigen?	Where do I need to get off?
der Ausweis	Hier ist mein Ausweis.	Here is my ID.
(sich) ausziehen	Zieh die Schuhe aus, bitte!	Take off your shoes, please!
das Auto, -s	Er kommt mit dem Auto.	He comes by car.
die Autobahn, -en	Wo geht‘s hier bitte zur Autobahn?	Where is the motorway, please?
der Automat	Die Fahrkarten gibt es nur am Automaten.	Tickets are only available at the vending machine.
automatisch	Du musst nichts machen. Das geht automatisch.	You don't have to do anything. It happens automatically.

